fecha	IRAG_GEN_Ocupadas	IRAG_GEN_Disponibles	IRAG_GEN_Total	IRAG_VENT_Ocupadas	IRAG_VENT_Disponibles	IRAG_VENT_Total	estado
2020-04-07	3	14	17	1	21	22	Aguascalientes
2020-04-08	4	14	18	1	21	22	Aguascalientes
2020-04-09	1	67	68	1	23	24	Aguascalientes
2020-04-10	1	164	165	2	35	37	Aguascalientes
2020-04-11	2	68	70	2	32	34	Aguascalientes
2020-04-12	3	68	71	2	31	33	Aguascalientes
2020-04-13	4	68	72	3	31	34	Aguascalientes
2020-04-14	2	43	45	3	37	40	Aguascalientes
2020-04-15	1	102	103	3	96	99	Aguascalientes
2020-04-16	2	102	104	4	96	100	Aguascalientes
2020-04-17	2	102	104	3	76	79	Aguascalientes
2020-04-18	5	102	107	2	88	90	Aguascalientes
2020-04-19	7	102	109	3	88	91	Aguascalientes
2020-04-20	5	104	109	3	124	127	Aguascalientes
2020-04-21	6	104	110	3	190	193	Aguascalientes
2020-04-22	7	104	111	4	99	103	Aguascalientes
2020-04-23	8	104	112	3	99	102	Aguascalientes
2020-04-24	8	104	112	4	99	103	Aguascalientes
2020-04-25	8	104	112	5	101	106	Aguascalientes
2020-04-26	6	120	126	5	97	102	Aguascalientes
2020-04-27	9	120	129	7	97	104	Aguascalientes
2020-04-28	10	120	130	5	63	68	Aguascalientes
2020-04-29	13	120	133	6	58	64	Aguascalientes
2020-04-30	14	120	134	5	57	62	Aguascalientes
2020-05-01	12	120	132	6	55	61	Aguascalientes
2020-05-02	11	120	131	6	57	63	Aguascalientes
2020-05-03	11	120	131	6	60	66	Aguascalientes
2020-05-04	11	120	131	6	52	58	Aguascalientes
2020-05-05	11	120	131	6	55	61	Aguascalientes
2020-05-06	12	120	132	5	61	66	Aguascalientes
2020-05-07	10	120	130	4	59	63	Aguascalientes
2020-05-08	17	120	137	4	52	56	Aguascalientes
2020-05-09	18	120	138	5	55	60	Aguascalientes
2020-05-10	24	120	144	4	53	57	Aguascalientes
2020-05-11	17	120	137	4	48	52	Aguascalientes
2020-05-12	19	120	139	4	49	53	Aguascalientes
2020-05-13	16	120	136	6	53	59	Aguascalientes
2020-05-14	19	120	139	5	52	57	Aguascalientes
2020-05-15	21	120	141	5	54	59	Aguascalientes
2020-05-16	24	120	144	6	49	55	Aguascalientes
2020-05-17	24	120	144	6	54	60	Aguascalientes
2020-05-18	27	120	147	8	52	60	Aguascalientes
2020-05-19	24	120	144	8	47	55	Aguascalientes
2020-05-20	28	120	148	8	44	52	Aguascalientes
2020-05-21	30	120	150	9	52	61	Aguascalientes
2020-05-22	30	226	256	9	54	63	Aguascalientes
2020-05-23	36	251	287	12	55	67	Aguascalientes
2020-05-24	37	232	269	10	55	65	Aguascalientes
2020-05-25	41	232	273	9	58	67	Aguascalientes
2020-05-26	38	254	292	10	73	83	Aguascalientes
2020-05-27	60	301	361	19	117	136	Aguascalientes
2020-05-28	51	306	357	21	113	134	Aguascalientes
2020-05-29	41	314	355	21	111	132	Aguascalientes
2020-05-30	36	317	353	22	114	136	Aguascalientes
2020-05-31	43	308	351	23	112	135	Aguascalientes
2020-06-01	43	305	348	25	105	130	Aguascalientes
2020-06-02	45	313	358	26	104	130	Aguascalientes
2020-06-03	37	320	357	27	109	136	Aguascalientes
2020-06-04	47	317	364	29	111	140	Aguascalientes
2020-06-05	58	318	376	28	116	144	Aguascalientes
2020-06-06	69	308	377	33	110	143	Aguascalientes
2020-06-07	72	306	378	34	110	144	Aguascalientes
2020-06-08	82	299	381	33	108	141	Aguascalientes
2020-06-09	71	304	375	37	106	143	Aguascalientes
2020-06-10	74	300	374	32	115	147	Aguascalientes
2020-06-11	56	252	308	23	63	86	Aguascalientes
2020-06-12	78	301	379	33	110	143	Aguascalientes
2020-06-13	72	300	372	34	110	144	Aguascalientes
2020-06-14	72	310	382	39	111	150	Aguascalientes
2020-06-15	82	300	382	39	78	117	Aguascalientes
2020-06-16	53	256	309	29	59	88	Aguascalientes
2020-06-17	86	265	351	47	64	111	Aguascalientes
2020-06-18	76	273	349	43	64	107	Aguascalientes
2020-06-19	69	284	353	43	68	111	Aguascalientes
2020-06-20	71	282	353	45	64	109	Aguascalientes
2020-06-21	67	287	354	50	61	111	Aguascalientes
2020-06-22	78	279	357	48	68	116	Aguascalientes
2020-06-23	87	277	364	50	67	117	Aguascalientes
2020-06-24	92	278	370	47	66	113	Aguascalientes
2020-06-25	97	323	420	46	99	145	Aguascalientes
2020-06-26	91	326	417	48	103	151	Aguascalientes
2020-06-27	84	325	409	48	101	149	Aguascalientes
2020-06-28	101	314	415	42	109	151	Aguascalientes
2020-06-29	80	223	303	31	75	106	Aguascalientes
2020-06-30	122	294	416	43	112	155	Aguascalientes
2020-07-01	108	303	411	45	112	157	Aguascalientes
2020-07-02	102	303	405	51	99	150	Aguascalientes
2020-07-03	108	298	406	46	110	156	Aguascalientes
2020-07-04	104	302	406	44	111	155	Aguascalientes
2020-07-05	96	304	400	50	111	161	Aguascalientes
2020-07-06	107	297	404	40	111	151	Aguascalientes
2020-07-07	111	281	392	45	103	148	Aguascalientes
2020-07-08	114	305	419	50	102	152	Aguascalientes
2020-07-09	116	299	415	50	100	150	Aguascalientes
2020-07-10	119	292	411	43	106	149	Aguascalientes
2020-07-11	104	301	405	41	109	150	Aguascalientes
2020-07-12	108	309	417	42	103	145	Aguascalientes
2020-07-13	113	298	411	37	100	137	Aguascalientes
2020-07-14	100	302	402	41	105	146	Aguascalientes
2020-07-15	96	318	414	41	107	148	Aguascalientes
2020-07-16	91	318	409	37	105	142	Aguascalientes
2020-07-17	99	314	413	41	104	145	Aguascalientes
2020-07-18	98	315	413	46	99	145	Aguascalientes
2020-07-19	98	315	413	53	90	143	Aguascalientes
2020-07-20	103	306	409	54	95	149	Aguascalientes
2020-07-21	97	316	413	57	92	149	Aguascalientes
2020-07-22	104	303	407	54	95	149	Aguascalientes
2020-07-23	90	321	411	56	90	146	Aguascalientes
2020-07-24	87	320	407	54	97	151	Aguascalientes
2020-07-25	89	316	405	52	97	149	Aguascalientes
2020-07-26	94	312	406	52	98	150	Aguascalientes
2020-07-27	103	312	415	53	95	148	Aguascalientes
2020-07-28	100	311	411	60	79	139	Aguascalientes
2020-07-29	107	311	418	62	86	148	Aguascalientes
2020-07-30	98	318	416	63	88	151	Aguascalientes
2020-07-31	117	297	414	61	90	151	Aguascalientes
2020-08-01	121	310	431	62	90	152	Aguascalientes
2020-08-02	122	304	426	59	96	155	Aguascalientes
2020-08-03	138	295	433	61	94	155	Aguascalientes
2020-08-04	131	267	398	61	90	151	Aguascalientes
2020-08-05	130	288	418	65	90	155	Aguascalientes
2020-08-06	135	257	392	66	84	150	Aguascalientes
2020-08-07	140	255	395	66	87	153	Aguascalientes
2020-08-08	140	253	393	70	87	157	Aguascalientes
2020-08-09	140	274	414	70	88	158	Aguascalientes
2020-08-10	140	255	395	74	79	153	Aguascalientes
2020-08-11	143	251	394	79	78	157	Aguascalientes
2020-08-12	147	271	418	76	91	167	Aguascalientes
2020-08-13	143	250	393	74	88	162	Aguascalientes
2020-08-14	144	292	436	70	88	158	Aguascalientes
2020-08-15	147	283	430	65	91	156	Aguascalientes
2020-08-16	131	263	394	73	81	154	Aguascalientes
2020-08-17	144	276	420	78	96	174	Aguascalientes
2020-08-18	148	250	398	73	77	150	Aguascalientes
2020-08-19	141	330	471	75	100	175	Aguascalientes
2020-08-20	112	336	448	96	110	206	Aguascalientes
2020-08-21	118	335	453	102	98	200	Aguascalientes
2020-08-22	117	326	443	103	112	215	Aguascalientes
2020-08-23	140	314	454	105	98	203	Aguascalientes
2020-08-24	137	314	451	115	91	206	Aguascalientes
2020-08-25	145	315	460	108	87	195	Aguascalientes
2020-08-26	147	310	457	105	96	201	Aguascalientes
2020-08-27	150	313	463	98	92	190	Aguascalientes
2020-08-28	142	314	456	98	96	194	Aguascalientes
2020-08-29	135	317	452	106	103	209	Aguascalientes
2020-08-30	126	194	320	56	79	135	Aguascalientes
2020-08-31	158	286	444	102	110	212	Aguascalientes
2020-09-01	151	294	445	110	108	218	Aguascalientes
2020-09-02	154	286	440	103	107	210	Aguascalientes
2020-09-03	151	289	440	106	107	213	Aguascalientes
2020-09-04	147	291	438	105	111	216	Aguascalientes
2020-09-05	139	264	403	105	111	216	Aguascalientes
2020-09-06	130	308	438	93	121	214	Aguascalientes
2020-04-07	57	173	230	11	149	160	Baja California
2020-04-08	57	165	222	8	129	137	Baja California
2020-04-09	64	168	232	7	90	97	Baja California
2020-04-10	63	168	231	6	94	100	Baja California
2020-04-11	57	154	211	4	91	95	Baja California
2020-04-12	57	154	211	4	91	95	Baja California
2020-04-13	57	154	211	5	68	73	Baja California
2020-04-14	60	134	194	4	73	77	Baja California
2020-04-15	58	134	192	4	84	88	Baja California
2020-04-16	57	134	191	3	75	78	Baja California
2020-04-17	54	134	188	3	76	79	Baja California
2020-04-18	61	134	195	3	90	93	Baja California
2020-04-19	63	134	197	3	65	68	Baja California
2020-04-20	241	328	569	57	133	190	Baja California
2020-04-21	266	344	610	67	217	284	Baja California
2020-04-22	151	213	364	23	167	190	Baja California
2020-04-23	257	282	539	70	178	248	Baja California
2020-04-24	177	296	473	41	199	240	Baja California
2020-04-25	295	308	603	90	204	294	Baja California
2020-04-26	319	287	606	80	197	277	Baja California
2020-04-27	225	285	510	47	202	249	Baja California
2020-04-28	282	356	638	78	99	177	Baja California
2020-04-29	501	366	867	86	90	176	Baja California
2020-04-30	499	361	860	82	84	166	Baja California
2020-05-01	496	316	812	85	80	165	Baja California
2020-05-02	386	346	732	52	78	130	Baja California
2020-05-03	508	297	805	87	95	182	Baja California
2020-05-04	541	290	831	88	96	184	Baja California
2020-05-05	501	375	876	88	102	190	Baja California
2020-05-06	524	349	873	89	106	195	Baja California
2020-05-07	544	353	897	83	105	188	Baja California
2020-05-08	544	371	915	79	89	168	Baja California
2020-05-09	511	374	885	89	90	179	Baja California
2020-05-10	517	366	883	88	95	183	Baja California
2020-05-11	505	381	886	83	96	179	Baja California
2020-05-12	407	339	746	47	78	125	Baja California
2020-05-13	496	383	879	87	97	184	Baja California
2020-05-14	460	389	849	94	88	182	Baja California
2020-05-15	448	416	864	93	67	160	Baja California
2020-05-16	467	397	864	95	87	182	Baja California
2020-05-17	475	402	877	100	77	177	Baja California
2020-05-18	479	394	873	102	74	176	Baja California
2020-05-19	458	418	876	109	105	214	Baja California
2020-05-20	426	470	896	102	80	182	Baja California
2020-05-21	466	431	897	105	89	194	Baja California
2020-05-22	436	430	866	162	89	251	Baja California
2020-05-23	357	322	679	127	81	208	Baja California
2020-05-24	412	344	756	165	95	260	Baja California
2020-05-25	435	361	796	157	99	256	Baja California
2020-05-26	395	374	769	165	90	255	Baja California
2020-05-27	397	369	766	173	84	257	Baja California
2020-05-28	402	373	775	175	70	245	Baja California
2020-05-29	403	377	780	170	78	248	Baja California
2020-05-30	380	352	732	163	71	234	Baja California
2020-05-31	395	383	778	165	84	249	Baja California
2020-06-01	394	379	773	173	85	258	Baja California
2020-06-02	369	429	798	174	72	246	Baja California
2020-06-03	401	339	740	170	86	256	Baja California
2020-06-04	329	267	596	150	59	209	Baja California
2020-06-05	332	260	592	134	72	206	Baja California
2020-06-06	386	313	699	173	95	268	Baja California
2020-06-07	404	305	709	173	90	263	Baja California
2020-06-08	399	330	729	172	84	256	Baja California
2020-06-09	410	334	744	162	99	261	Baja California
2020-06-10	363	257	620	135	92	227	Baja California
2020-06-11	381	360	741	170	91	261	Baja California
2020-06-12	404	373	777	164	95	259	Baja California
2020-06-13	395	381	776	157	107	264	Baja California
2020-06-14	385	365	750	170	93	263	Baja California
2020-06-15	421	375	796	151	95	246	Baja California
2020-06-16	388	362	750	157	85	242	Baja California
2020-06-17	402	332	734	155	87	242	Baja California
2020-06-18	380	368	748	159	93	252	Baja California
2020-06-19	340	264	604	124	80	204	Baja California
2020-06-20	370	335	705	173	92	265	Baja California
2020-06-21	377	336	713	170	101	271	Baja California
2020-06-22	382	366	748	169	110	279	Baja California
2020-06-23	394	364	758	178	92	270	Baja California
2020-06-24	388	378	766	176	85	261	Baja California
2020-06-25	409	360	769	166	90	256	Baja California
2020-06-26	388	350	738	175	84	259	Baja California
2020-06-27	354	342	696	185	107	292	Baja California
2020-06-28	439	309	748	180	109	289	Baja California
2020-06-29	438	316	754	180	98	278	Baja California
2020-06-30	426	359	785	174	112	286	Baja California
2020-07-01	432	358	790	182	125	307	Baja California
2020-07-02	470	424	894	171	106	277	Baja California
2020-07-03	452	415	867	183	111	294	Baja California
2020-07-04	402	349	751	185	116	301	Baja California
2020-07-05	458	430	888	183	112	295	Baja California
2020-07-06	436	457	893	186	111	297	Baja California
2020-07-07	472	469	941	160	135	295	Baja California
2020-07-08	455	394	849	154	144	298	Baja California
2020-07-09	454	401	855	155	127	282	Baja California
2020-07-10	418	469	887	172	126	298	Baja California
2020-07-11	383	489	872	167	123	290	Baja California
2020-07-12	362	488	850	146	115	261	Baja California
2020-07-13	402	498	900	157	130	287	Baja California
2020-07-14	423	486	909	155	129	284	Baja California
2020-07-15	391	444	835	166	123	289	Baja California
2020-07-16	369	466	835	167	117	284	Baja California
2020-07-17	394	461	855	166	119	285	Baja California
2020-07-18	354	497	851	169	124	293	Baja California
2020-07-19	416	440	856	160	114	274	Baja California
2020-07-20	423	429	852	158	129	287	Baja California
2020-07-21	359	466	825	160	123	283	Baja California
2020-07-22	344	460	804	167	123	290	Baja California
2020-07-23	367	466	833	164	125	289	Baja California
2020-07-24	317	468	785	166	121	287	Baja California
2020-07-25	275	508	783	158	135	293	Baja California
2020-07-26	326	481	807	145	140	285	Baja California
2020-07-27	301	474	775	151	121	272	Baja California
2020-07-28	338	503	841	139	148	287	Baja California
2020-07-29	339	475	814	145	146	291	Baja California
2020-07-30	333	485	818	144	141	285	Baja California
2020-07-31	348	508	856	140	145	285	Baja California
2020-08-01	348	466	814	142	136	278	Baja California
2020-08-02	352	459	811	145	132	277	Baja California
2020-08-03	351	471	822	140	140	280	Baja California
2020-08-04	337	489	826	143	142	285	Baja California
2020-08-05	311	460	771	141	146	287	Baja California
2020-08-06	301	518	819	136	155	291	Baja California
2020-08-07	306	501	807	136	154	290	Baja California
2020-08-08	305	545	850	144	153	297	Baja California
2020-08-09	298	493	791	132	165	297	Baja California
2020-08-10	296	535	831	138	145	283	Baja California
2020-08-11	292	537	829	137	151	288	Baja California
2020-08-12	294	559	853	127	160	287	Baja California
2020-08-13	300	583	883	130	159	289	Baja California
2020-08-14	290	472	762	126	157	283	Baja California
2020-08-15	288	502	790	126	167	293	Baja California
2020-08-16	282	501	783	129	165	294	Baja California
2020-08-17	285	540	825	116	170	286	Baja California
2020-08-18	294	529	823	127	162	289	Baja California
2020-08-19	286	534	820	114	172	286	Baja California
2020-08-20	301	520	821	112	165	277	Baja California
2020-08-21	299	529	828	101	167	268	Baja California
2020-08-22	270	546	816	105	176	281	Baja California
2020-08-23	272	544	816	113	164	277	Baja California
2020-08-24	258	561	819	113	152	265	Baja California
2020-08-25	241	546	787	95	132	227	Baja California
2020-08-26	262	548	810	106	158	264	Baja California
2020-08-27	249	572	821	106	157	263	Baja California
2020-08-28	257	558	815	114	148	262	Baja California
2020-08-29	254	532	786	115	143	258	Baja California
2020-08-30	256	569	825	105	150	255	Baja California
2020-08-31	258	518	776	96	166	262	Baja California
2020-09-01	243	580	823	94	171	265	Baja California
2020-09-02	243	573	816	94	172	266	Baja California
2020-09-03	235	567	802	95	169	264	Baja California
2020-09-04	227	523	750	79	114	193	Baja California
2020-09-05	236	572	808	96	170	266	Baja California
2020-09-06	242	597	839	89	182	271	Baja California
2020-04-07	8	40	48	4	30	34	Baja California Sur
2020-04-08	7	40	47	3	28	31	Baja California Sur
2020-04-09	10	41	51	3	3	6	Baja California Sur
2020-04-10	4	38	42	5	2	7	Baja California Sur
2020-04-11	14	51	65	4	14	18	Baja California Sur
2020-04-12	15	51	66	5	26	31	Baja California Sur
2020-04-13	18	52	70	3	27	30	Baja California Sur
2020-04-14	23	105	128	3	39	42	Baja California Sur
2020-04-15	19	51	70	5	27	32	Baja California Sur
2020-04-16	24	69	93	4	34	38	Baja California Sur
2020-04-17	25	98	123	8	67	75	Baja California Sur
2020-04-18	24	108	132	8	62	70	Baja California Sur
2020-04-19	23	105	128	12	54	66	Baja California Sur
2020-04-20	18	114	132	14	56	70	Baja California Sur
2020-04-21	24	112	136	13	49	62	Baja California Sur
2020-04-22	21	123	144	11	39	50	Baja California Sur
2020-04-23	16	125	141	10	40	50	Baja California Sur
2020-04-24	14	145	159	10	37	47	Baja California Sur
2020-04-25	13	118	131	9	34	43	Baja California Sur
2020-04-26	14	137	151	8	42	50	Baja California Sur
2020-04-27	12	151	163	7	48	55	Baja California Sur
2020-04-28	13	233	246	9	55	64	Baja California Sur
2020-04-29	14	231	245	5	58	63	Baja California Sur
2020-04-30	13	199	212	6	45	51	Baja California Sur
2020-05-01	14	200	214	7	44	51	Baja California Sur
2020-05-02	16	201	217	6	45	51	Baja California Sur
2020-05-03	16	203	219	6	45	51	Baja California Sur
2020-05-04	17	201	218	5	49	54	Baja California Sur
2020-05-05	22	199	221	5	48	53	Baja California Sur
2020-05-06	24	183	207	4	46	50	Baja California Sur
2020-05-07	26	183	209	6	43	49	Baja California Sur
2020-05-08	28	186	214	6	39	45	Baja California Sur
2020-05-09	22	187	209	7	40	47	Baja California Sur
2020-05-10	19	190	209	6	41	47	Baja California Sur
2020-05-11	19	189	208	6	42	48	Baja California Sur
2020-05-12	24	185	209	5	46	51	Baja California Sur
2020-05-13	19	187	206	5	46	51	Baja California Sur
2020-05-14	20	194	214	5	47	52	Baja California Sur
2020-05-15	21	193	214	4	45	49	Baja California Sur
2020-05-16	15	194	209	6	48	54	Baja California Sur
2020-05-17	17	194	211	6	47	53	Baja California Sur
2020-05-18	15	196	211	7	45	52	Baja California Sur
2020-05-19	17	196	213	5	42	47	Baja California Sur
2020-05-20	16	195	211	6	40	46	Baja California Sur
2020-05-21	18	197	215	4	44	48	Baja California Sur
2020-05-22	17	187	204	5	41	46	Baja California Sur
2020-05-23	17	188	205	5	44	49	Baja California Sur
2020-05-24	18	198	216	5	42	47	Baja California Sur
2020-05-25	16	208	224	5	42	47	Baja California Sur
2020-05-26	20	213	233	6	42	48	Baja California Sur
2020-05-27	28	197	225	5	41	46	Baja California Sur
2020-05-28	24	192	216	8	44	52	Baja California Sur
2020-05-29	28	217	245	6	49	55	Baja California Sur
2020-05-30	26	217	243	10	44	54	Baja California Sur
2020-05-31	27	219	246	10	43	53	Baja California Sur
2020-06-01	29	217	246	10	43	53	Baja California Sur
2020-06-02	25	220	245	12	35	47	Baja California Sur
2020-06-03	28	219	247	11	35	46	Baja California Sur
2020-06-04	22	219	241	13	35	48	Baja California Sur
2020-06-05	20	222	242	11	36	47	Baja California Sur
2020-06-06	19	225	244	12	35	47	Baja California Sur
2020-06-07	21	224	245	11	36	47	Baja California Sur
2020-06-08	17	228	245	12	36	48	Baja California Sur
2020-06-09	21	229	250	14	36	50	Baja California Sur
2020-06-10	25	228	253	13	30	43	Baja California Sur
2020-06-11	29	186	215	12	52	64	Baja California Sur
2020-06-12	20	184	204	19	53	72	Baja California Sur
2020-06-13	20	226	246	19	88	107	Baja California Sur
2020-06-14	18	228	246	17	90	107	Baja California Sur
2020-06-15	20	230	250	16	92	108	Baja California Sur
2020-06-16	17	236	253	12	103	115	Baja California Sur
2020-06-17	18	231	249	15	100	115	Baja California Sur
2020-06-18	23	229	252	15	111	126	Baja California Sur
2020-06-19	25	228	253	13	102	115	Baja California Sur
2020-06-20	26	241	267	13	99	112	Baja California Sur
2020-06-21	30	221	251	12	100	112	Baja California Sur
2020-06-22	31	249	280	15	94	109	Baja California Sur
2020-06-23	20	250	270	15	98	113	Baja California Sur
2020-06-24	38	244	282	15	99	114	Baja California Sur
2020-06-25	44	242	286	16	96	112	Baja California Sur
2020-06-26	45	212	257	16	97	113	Baja California Sur
2020-06-27	44	240	284	18	94	112	Baja California Sur
2020-06-28	40	211	251	18	93	111	Baja California Sur
2020-06-29	38	211	249	19	89	108	Baja California Sur
2020-06-30	37	238	275	26	83	109	Baja California Sur
2020-07-01	41	230	271	25	91	116	Baja California Sur
2020-07-02	44	229	273	24	94	118	Baja California Sur
2020-07-03	54	226	280	17	100	117	Baja California Sur
2020-07-04	54	227	281	21	92	113	Baja California Sur
2020-07-05	53	231	284	25	89	114	Baja California Sur
2020-07-06	55	230	285	21	97	118	Baja California Sur
2020-07-07	64	234	298	21	95	116	Baja California Sur
2020-07-08	73	235	308	26	92	118	Baja California Sur
2020-07-09	79	226	305	31	86	117	Baja California Sur
2020-07-10	82	228	310	27	91	118	Baja California Sur
2020-07-11	80	186	266	31	82	113	Baja California Sur
2020-07-12	79	174	253	31	102	133	Baja California Sur
2020-07-13	84	142	226	34	96	130	Baja California Sur
2020-07-14	94	162	256	35	99	134	Baja California Sur
2020-07-15	84	168	252	40	94	134	Baja California Sur
2020-07-16	80	177	257	46	80	126	Baja California Sur
2020-07-17	73	191	264	45	82	127	Baja California Sur
2020-07-18	73	193	266	44	85	129	Baja California Sur
2020-07-19	87	178	265	43	86	129	Baja California Sur
2020-07-20	104	175	279	38	91	129	Baja California Sur
2020-07-21	100	150	250	38	98	136	Baja California Sur
2020-07-22	98	152	250	40	110	150	Baja California Sur
2020-07-23	114	143	257	47	112	159	Baja California Sur
2020-07-24	111	143	254	48	110	158	Baja California Sur
2020-07-25	116	145	261	48	114	162	Baja California Sur
2020-07-26	117	139	256	48	115	163	Baja California Sur
2020-07-27	122	139	261	49	111	160	Baja California Sur
2020-07-28	123	100	223	42	89	131	Baja California Sur
2020-07-29	136	120	256	45	131	176	Baja California Sur
2020-07-30	149	114	263	51	132	183	Baja California Sur
2020-07-31	129	128	257	51	120	171	Baja California Sur
2020-08-01	126	136	262	52	118	170	Baja California Sur
2020-08-02	121	144	265	55	116	171	Baja California Sur
2020-08-03	137	128	265	51	122	173	Baja California Sur
2020-08-04	154	154	308	55	132	187	Baja California Sur
2020-08-05	157	141	298	61	119	180	Baja California Sur
2020-08-06	143	143	286	63	137	200	Baja California Sur
2020-08-07	121	149	270	63	111	174	Baja California Sur
2020-08-08	140	154	294	63	131	194	Baja California Sur
2020-08-09	138	151	289	72	130	202	Baja California Sur
2020-08-10	136	145	281	66	137	203	Baja California Sur
2020-08-11	119	180	299	74	133	207	Baja California Sur
2020-08-12	127	163	290	70	145	215	Baja California Sur
2020-08-13	118	191	309	66	150	216	Baja California Sur
2020-08-14	109	146	255	72	138	210	Baja California Sur
2020-08-15	110	173	283	69	141	210	Baja California Sur
2020-08-16	112	192	304	68	148	216	Baja California Sur
2020-08-17	110	202	312	66	152	218	Baja California Sur
2020-08-18	115	155	270	64	142	206	Baja California Sur
2020-08-19	104	194	298	59	132	191	Baja California Sur
2020-08-20	111	147	258	57	151	208	Baja California Sur
2020-08-21	120	183	303	58	146	204	Baja California Sur
2020-08-22	118	190	308	58	159	217	Baja California Sur
2020-08-23	122	186	308	58	161	219	Baja California Sur
2020-08-24	119	187	306	54	165	219	Baja California Sur
2020-08-25	118	186	304	51	166	217	Baja California Sur
2020-08-26	100	201	301	53	163	216	Baja California Sur
2020-08-27	101	155	256	53	207	260	Baja California Sur
2020-08-28	97	205	302	58	159	217	Baja California Sur
2020-08-29	86	210	296	64	155	219	Baja California Sur
2020-08-30	85	216	301	60	159	219	Baja California Sur
2020-08-31	83	216	299	64	150	214	Baja California Sur
2020-09-01	73	223	296	58	156	214	Baja California Sur
2020-09-02	70	219	289	50	136	186	Baja California Sur
2020-09-03	71	212	283	46	142	188	Baja California Sur
2020-09-04	84	212	296	47	164	211	Baja California Sur
2020-09-05	80	223	303	41	162	203	Baja California Sur
2020-09-06	84	219	303	43	162	205	Baja California Sur
2020-04-07	0	27	27	1	7	8	Campeche
2020-04-08	1	31	32	1	11	12	Campeche
2020-04-09	1	27	28	1	24	25	Campeche
2020-04-10	1	27	28	1	24	25	Campeche
2020-04-11	0	27	27	2	23	25	Campeche
2020-04-12	0	27	27	2	21	23	Campeche
2020-04-13	4	27	31	2	20	22	Campeche
2020-04-14	4	27	31	2	20	22	Campeche
2020-04-15	3	27	30	3	19	22	Campeche
2020-04-16	3	27	30	3	19	22	Campeche
2020-04-17	3	27	30	3	17	20	Campeche
2020-04-18	1	27	28	3	19	22	Campeche
2020-04-19	1	28	29	3	18	21	Campeche
2020-04-20	2	28	30	3	19	22	Campeche
2020-04-21	7	32	39	3	99	102	Campeche
2020-04-22	7	32	39	3	38	41	Campeche
2020-04-23	6	33	39	3	38	41	Campeche
2020-04-24	10	32	42	3	38	41	Campeche
2020-04-25	11	31	42	3	38	41	Campeche
2020-04-26	9	32	41	3	43	46	Campeche
2020-04-27	18	56	74	5	45	50	Campeche
2020-04-28	16	45	61	4	39	43	Campeche
2020-04-29	21	45	66	3	38	41	Campeche
2020-04-30	22	44	66	4	37	41	Campeche
2020-05-01	32	76	108	5	62	67	Campeche
2020-05-02	29	77	106	5	64	69	Campeche
2020-05-03	38	77	115	3	59	62	Campeche
2020-05-04	38	69	107	3	64	67	Campeche
2020-05-05	45	65	110	4	55	59	Campeche
2020-05-06	45	65	110	4	54	58	Campeche
2020-05-07	38	59	97	2	48	50	Campeche
2020-05-08	56	67	123	5	47	52	Campeche
2020-05-09	47	64	111	5	45	50	Campeche
2020-05-10	54	63	117	9	47	56	Campeche
2020-05-11	58	413	471	8	75	83	Campeche
2020-05-12	41	403	444	7	72	79	Campeche
2020-05-13	55	407	462	13	73	86	Campeche
2020-05-14	52	343	395	15	73	88	Campeche
2020-05-15	45	350	395	15	75	90	Campeche
2020-05-16	53	345	398	15	73	88	Campeche
2020-05-17	56	352	408	15	74	89	Campeche
2020-05-18	42	360	402	15	75	90	Campeche
2020-05-19	40	338	378	5	71	76	Campeche
2020-05-20	57	359	416	11	69	80	Campeche
2020-05-21	60	369	429	12	71	83	Campeche
2020-05-22	68	373	441	12	67	79	Campeche
2020-05-23	53	367	420	10	61	71	Campeche
2020-05-24	60	370	430	9	61	70	Campeche
2020-05-25	68	381	449	10	53	63	Campeche
2020-05-26	57	371	428	6	55	61	Campeche
2020-05-27	67	382	449	9	66	75	Campeche
2020-05-28	62	320	382	7	46	53	Campeche
2020-05-29	72	396	468	10	47	57	Campeche
2020-05-30	58	351	409	7	54	61	Campeche
2020-05-31	78	364	442	9	57	66	Campeche
2020-06-01	63	356	419	10	55	65	Campeche
2020-06-02	78	345	423	12	54	66	Campeche
2020-06-03	79	366	445	14	54	68	Campeche
2020-06-04	75	373	448	11	59	70	Campeche
2020-06-05	74	412	486	13	55	68	Campeche
2020-06-06	64	397	461	8	55	63	Campeche
2020-06-07	66	394	460	11	55	66	Campeche
2020-06-08	83	369	452	14	53	67	Campeche
2020-06-09	94	361	455	15	50	65	Campeche
2020-06-10	94	365	459	15	55	70	Campeche
2020-06-11	92	404	496	18	50	68	Campeche
2020-06-12	93	390	483	18	47	65	Campeche
2020-06-13	90	378	468	15	52	67	Campeche
2020-06-14	103	390	493	22	49	71	Campeche
2020-06-15	104	391	495	16	49	65	Campeche
2020-06-16	103	372	475	17	51	68	Campeche
2020-06-17	113	360	473	20	51	71	Campeche
2020-06-18	131	374	505	20	56	76	Campeche
2020-06-19	125	379	504	20	60	80	Campeche
2020-06-20	124	382	506	19	57	76	Campeche
2020-06-21	132	381	513	20	59	79	Campeche
2020-06-22	150	396	546	22	62	84	Campeche
2020-06-23	163	380	543	24	58	82	Campeche
2020-06-24	180	367	547	25	55	80	Campeche
2020-06-25	172	209	381	28	52	80	Campeche
2020-06-26	162	335	497	24	50	74	Campeche
2020-06-27	171	384	555	29	57	86	Campeche
2020-06-28	177	371	548	28	53	81	Campeche
2020-06-29	191	352	543	28	56	84	Campeche
2020-06-30	197	358	555	29	54	83	Campeche
2020-07-01	201	342	543	35	49	84	Campeche
2020-07-02	221	446	667	32	72	104	Campeche
2020-07-03	215	392	607	32	108	140	Campeche
2020-07-04	230	405	635	32	107	139	Campeche
2020-07-05	240	419	659	34	109	143	Campeche
2020-07-06	246	383	629	31	134	165	Campeche
2020-07-07	238	396	634	32	110	142	Campeche
2020-07-08	261	458	719	31	111	142	Campeche
2020-07-09	261	439	700	31	109	140	Campeche
2020-07-10	250	457	707	29	112	141	Campeche
2020-07-11	214	432	646	20	114	134	Campeche
2020-07-12	247	454	701	29	111	140	Campeche
2020-07-13	240	456	696	25	108	133	Campeche
2020-07-14	254	440	694	31	108	139	Campeche
2020-07-15	254	434	688	36	101	137	Campeche
2020-07-16	245	395	640	29	101	130	Campeche
2020-07-17	262	427	689	26	108	134	Campeche
2020-07-18	271	415	686	29	109	138	Campeche
2020-07-19	255	431	686	22	112	134	Campeche
2020-07-20	249	424	673	27	109	136	Campeche
2020-07-21	254	389	643	25	111	136	Campeche
2020-07-22	241	410	651	24	112	136	Campeche
2020-07-23	243	414	657	26	109	135	Campeche
2020-07-24	224	463	687	31	106	137	Campeche
2020-07-25	256	442	698	33	107	140	Campeche
2020-07-26	214	458	672	32	106	138	Campeche
2020-07-27	212	438	650	24	111	135	Campeche
2020-07-28	232	451	683	21	116	137	Campeche
2020-07-29	216	476	692	21	117	138	Campeche
2020-07-30	241	439	680	28	110	138	Campeche
2020-07-31	229	461	690	27	110	137	Campeche
2020-08-01	210	456	666	22	112	134	Campeche
2020-08-02	208	500	708	21	113	134	Campeche
2020-08-03	200	420	620	21	113	134	Campeche
2020-08-04	198	496	694	23	115	138	Campeche
2020-08-05	187	509	696	21	118	139	Campeche
2020-08-06	166	540	706	19	119	138	Campeche
2020-08-07	149	553	702	19	119	138	Campeche
2020-08-08	148	540	688	18	120	138	Campeche
2020-08-09	140	544	684	21	117	138	Campeche
2020-08-10	143	549	692	23	114	137	Campeche
2020-08-11	140	520	660	23	114	137	Campeche
2020-08-12	135	533	668	23	115	138	Campeche
2020-08-13	134	489	623	16	81	97	Campeche
2020-08-14	138	513	651	17	121	138	Campeche
2020-08-15	122	523	645	19	118	137	Campeche
2020-08-16	115	543	658	17	121	138	Campeche
2020-08-17	125	552	677	16	123	139	Campeche
2020-08-18	123	550	673	17	122	139	Campeche
2020-08-19	126	548	674	17	120	137	Campeche
2020-08-20	127	548	675	12	125	137	Campeche
2020-08-21	109	555	664	17	120	137	Campeche
2020-08-22	110	559	669	16	120	136	Campeche
2020-08-23	102	571	673	13	122	135	Campeche
2020-08-24	92	572	664	9	124	133	Campeche
2020-08-25	94	577	671	8	124	132	Campeche
2020-08-26	87	582	669	11	122	133	Campeche
2020-08-27	82	557	639	13	120	133	Campeche
2020-08-28	73	582	655	18	118	136	Campeche
2020-08-29	60	368	428	14	38	52	Campeche
2020-08-30	59	591	650	15	117	132	Campeche
2020-08-31	70	596	666	11	122	133	Campeche
2020-09-01	75	578	653	10	125	135	Campeche
2020-09-02	76	591	667	9	124	133	Campeche
2020-09-03	73	592	665	13	123	136	Campeche
2020-09-04	63	602	665	14	123	137	Campeche
2020-09-05	60	603	663	14	124	138	Campeche
2020-09-06	57	611	668	14	124	138	Campeche
2020-04-07	7	16	23	1	26	27	Chiapas
2020-04-08	5	16	21	1	22	23	Chiapas
2020-04-09	5	35	40	0	16	16	Chiapas
2020-04-10	6	33	39	0	16	16	Chiapas
2020-04-11	4	35	39	1	16	17	Chiapas
2020-04-12	2	38	40	1	16	17	Chiapas
2020-04-13	2	37	39	2	15	17	Chiapas
2020-04-14	3	38	41	1	14	15	Chiapas
2020-04-15	3	38	41	1	13	14	Chiapas
2020-04-16	1	38	39	2	15	17	Chiapas
2020-04-17	5	36	41	2	15	17	Chiapas
2020-04-18	7	35	42	3	12	15	Chiapas
2020-04-19	6	35	41	3	13	16	Chiapas
2020-04-20	6	35	41	3	13	16	Chiapas
2020-04-21	6	82	88	3	102	105	Chiapas
2020-04-22	5	96	101	3	50	53	Chiapas
2020-04-23	6	113	119	3	46	49	Chiapas
2020-04-24	7	115	122	3	46	49	Chiapas
2020-04-25	6	114	120	4	46	50	Chiapas
2020-04-26	7	127	134	4	68	72	Chiapas
2020-04-27	10	126	136	4	68	72	Chiapas
2020-04-28	8	127	135	5	54	59	Chiapas
2020-04-29	14	160	174	7	61	68	Chiapas
2020-04-30	11	157	168	8	57	65	Chiapas
2020-05-01	14	240	254	9	89	98	Chiapas
2020-05-02	20	237	257	9	85	94	Chiapas
2020-05-03	18	212	230	10	67	77	Chiapas
2020-05-04	17	223	240	11	75	86	Chiapas
2020-05-05	36	224	260	12	82	94	Chiapas
2020-05-06	39	219	258	12	75	87	Chiapas
2020-05-07	34	236	270	11	74	85	Chiapas
2020-05-08	42	228	270	19	70	89	Chiapas
2020-05-09	47	222	269	19	69	88	Chiapas
2020-05-10	48	206	254	16	68	84	Chiapas
2020-05-11	45	232	277	15	87	102	Chiapas
2020-05-12	55	251	306	28	79	107	Chiapas
2020-05-13	54	261	315	33	88	121	Chiapas
2020-05-14	40	260	300	22	85	107	Chiapas
2020-05-15	85	272	357	39	83	122	Chiapas
2020-05-16	86	257	343	35	79	114	Chiapas
2020-05-17	65	211	276	26	65	91	Chiapas
2020-05-18	97	250	347	49	64	113	Chiapas
2020-05-19	100	240	340	49	55	104	Chiapas
2020-05-20	110	237	347	49	64	113	Chiapas
2020-05-21	105	232	337	41	48	89	Chiapas
2020-05-22	135	237	372	58	65	123	Chiapas
2020-05-23	139	216	355	64	54	118	Chiapas
2020-05-24	115	237	352	61	58	119	Chiapas
2020-05-25	168	282	450	73	61	134	Chiapas
2020-05-26	168	278	446	76	59	135	Chiapas
2020-05-27	180	207	387	88	64	152	Chiapas
2020-05-28	186	212	398	110	75	185	Chiapas
2020-05-29	213	167	380	104	78	182	Chiapas
2020-05-30	162	154	316	89	70	159	Chiapas
2020-05-31	180	172	352	103	82	185	Chiapas
2020-06-01	198	174	372	94	119	213	Chiapas
2020-06-02	228	183	411	107	103	210	Chiapas
2020-06-03	224	181	405	121	108	229	Chiapas
2020-06-04	248	181	429	115	118	233	Chiapas
2020-06-05	265	190	455	118	128	246	Chiapas
2020-06-06	274	205	479	121	147	268	Chiapas
2020-06-07	282	175	457	105	131	236	Chiapas
2020-06-08	227	348	575	108	174	282	Chiapas
2020-06-09	314	506	820	122	189	311	Chiapas
2020-06-10	288	548	836	118	217	335	Chiapas
2020-06-11	331	522	853	121	200	321	Chiapas
2020-06-12	313	548	861	121	245	366	Chiapas
2020-06-13	273	535	808	127	225	352	Chiapas
2020-06-14	269	534	803	127	217	344	Chiapas
2020-06-15	303	552	855	131	213	344	Chiapas
2020-06-16	324	497	821	122	217	339	Chiapas
2020-06-17	289	503	792	120	218	338	Chiapas
2020-06-18	322	499	821	114	207	321	Chiapas
2020-06-19	289	496	785	112	211	323	Chiapas
2020-06-20	280	499	779	123	204	327	Chiapas
2020-06-21	303	505	808	114	227	341	Chiapas
2020-06-22	295	505	800	123	249	372	Chiapas
2020-06-23	311	474	785	127	216	343	Chiapas
2020-06-24	324	496	820	116	229	345	Chiapas
2020-06-25	318	503	821	122	222	344	Chiapas
2020-06-26	317	493	810	123	228	351	Chiapas
2020-06-27	321	484	805	126	221	347	Chiapas
2020-06-28	348	497	845	125	231	356	Chiapas
2020-06-29	396	504	900	127	229	356	Chiapas
2020-06-30	343	506	849	135	229	364	Chiapas
2020-07-01	343	496	839	131	229	360	Chiapas
2020-07-02	325	516	841	140	225	365	Chiapas
2020-07-03	332	514	846	132	240	372	Chiapas
2020-07-04	342	556	898	113	262	375	Chiapas
2020-07-05	344	607	951	109	352	461	Chiapas
2020-07-06	301	639	940	109	371	480	Chiapas
2020-07-07	297	570	867	110	369	479	Chiapas
2020-07-08	321	583	904	107	293	400	Chiapas
2020-07-09	312	560	872	110	265	375	Chiapas
2020-07-10	316	592	908	103	265	368	Chiapas
2020-07-11	285	538	823	109	271	380	Chiapas
2020-07-12	289	535	824	103	269	372	Chiapas
2020-07-13	267	407	674	97	289	386	Chiapas
2020-07-14	268	409	677	87	295	382	Chiapas
2020-07-15	256	396	652	88	301	389	Chiapas
2020-07-16	203	403	606	75	314	389	Chiapas
2020-07-17	244	423	667	94	311	405	Chiapas
2020-07-18	235	442	677	85	316	401	Chiapas
2020-07-19	215	426	641	87	319	406	Chiapas
2020-07-20	221	420	641	81	314	395	Chiapas
2020-07-21	218	417	635	86	306	392	Chiapas
2020-07-22	212	421	633	91	304	395	Chiapas
2020-07-23	212	424	636	92	306	398	Chiapas
2020-07-24	203	428	631	97	308	405	Chiapas
2020-07-25	188	413	601	102	304	406	Chiapas
2020-07-26	189	392	581	99	313	412	Chiapas
2020-07-27	191	413	604	99	299	398	Chiapas
2020-07-28	186	402	588	95	294	389	Chiapas
2020-07-29	188	409	597	89	294	383	Chiapas
2020-07-30	185	413	598	88	297	385	Chiapas
2020-07-31	182	431	613	91	306	397	Chiapas
2020-08-01	181	406	587	85	296	381	Chiapas
2020-08-02	181	405	586	86	285	371	Chiapas
2020-08-03	172	407	579	96	299	395	Chiapas
2020-08-04	160	373	533	96	307	403	Chiapas
2020-08-05	135	366	501	97	277	374	Chiapas
2020-08-06	138	358	496	83	280	363	Chiapas
2020-08-07	126	362	488	82	271	353	Chiapas
2020-08-08	125	355	480	81	271	352	Chiapas
2020-08-09	119	316	435	78	249	327	Chiapas
2020-08-10	114	331	445	70	271	341	Chiapas
2020-08-11	113	334	447	66	278	344	Chiapas
2020-08-12	103	338	441	71	272	343	Chiapas
2020-08-13	98	340	438	65	278	343	Chiapas
2020-08-14	88	353	441	61	288	349	Chiapas
2020-08-15	93	385	478	61	255	316	Chiapas
2020-08-16	89	384	473	40	260	300	Chiapas
2020-08-17	91	409	500	40	224	264	Chiapas
2020-08-18	73	417	490	41	234	275	Chiapas
2020-08-19	63	416	479	37	235	272	Chiapas
2020-08-20	55	426	481	31	237	268	Chiapas
2020-08-21	55	430	485	30	239	269	Chiapas
2020-08-22	55	429	484	28	239	267	Chiapas
2020-08-23	57	429	486	28	241	269	Chiapas
2020-08-24	55	427	482	34	238	272	Chiapas
2020-08-25	60	412	472	27	223	250	Chiapas
2020-08-26	57	422	479	24	245	269	Chiapas
2020-08-27	61	429	490	23	242	265	Chiapas
2020-08-28	53	433	486	21	229	250	Chiapas
2020-08-29	52	422	474	22	241	263	Chiapas
2020-08-30	45	422	467	26	240	266	Chiapas
2020-08-31	46	427	473	21	238	259	Chiapas
2020-09-01	45	425	470	20	239	259	Chiapas
2020-09-02	38	434	472	18	241	259	Chiapas
2020-09-03	41	436	477	13	243	256	Chiapas
2020-09-04	45	430	475	15	247	262	Chiapas
2020-09-05	28	433	461	14	247	261	Chiapas
2020-09-06	32	444	476	10	249	259	Chiapas
2020-04-07	18	151	169	8	137	145	Chihuahua
2020-04-08	19	144	163	6	130	136	Chihuahua
2020-04-09	20	145	165	8	128	136	Chihuahua
2020-04-10	18	148	166	10	131	141	Chihuahua
2020-04-11	14	145	159	13	122	135	Chihuahua
2020-04-12	17	158	175	12	120	132	Chihuahua
2020-04-13	40	158	198	14	123	137	Chihuahua
2020-04-14	37	158	195	14	112	126	Chihuahua
2020-04-15	37	158	195	15	106	121	Chihuahua
2020-04-16	38	159	197	15	109	124	Chihuahua
2020-04-17	41	248	289	16	120	136	Chihuahua
2020-04-18	40	252	292	16	130	146	Chihuahua
2020-04-19	42	254	296	16	131	147	Chihuahua
2020-04-20	45	318	363	16	143	159	Chihuahua
2020-04-21	42	335	377	17	596	613	Chihuahua
2020-04-22	45	418	463	20	205	225	Chihuahua
2020-04-23	44	427	471	20	212	232	Chihuahua
2020-04-24	44	483	527	21	210	231	Chihuahua
2020-04-25	44	614	658	17	197	214	Chihuahua
2020-04-26	41	620	661	18	227	245	Chihuahua
2020-04-27	45	625	670	20	247	267	Chihuahua
2020-04-28	68	624	692	21	185	206	Chihuahua
2020-04-29	150	608	758	21	184	205	Chihuahua
2020-04-30	171	571	742	8	173	181	Chihuahua
2020-05-01	197	617	814	12	186	198	Chihuahua
2020-05-02	193	620	813	15	187	202	Chihuahua
2020-05-03	227	623	850	16	197	213	Chihuahua
2020-05-04	200	606	806	14	208	222	Chihuahua
2020-05-05	201	618	819	9	194	203	Chihuahua
2020-05-06	214	626	840	12	193	205	Chihuahua
2020-05-07	230	626	856	12	188	200	Chihuahua
2020-05-08	195	630	825	22	193	215	Chihuahua
2020-05-09	198	630	828	26	169	195	Chihuahua
2020-05-10	185	634	819	32	158	190	Chihuahua
2020-05-11	170	633	803	33	152	185	Chihuahua
2020-05-12	168	638	806	31	158	189	Chihuahua
2020-05-13	165	618	783	31	161	192	Chihuahua
2020-05-14	178	617	795	29	167	196	Chihuahua
2020-05-15	180	619	799	32	163	195	Chihuahua
2020-05-16	162	623	785	43	158	201	Chihuahua
2020-05-17	157	623	780	46	168	214	Chihuahua
2020-05-18	144	624	768	44	166	210	Chihuahua
2020-05-19	195	674	869	45	183	228	Chihuahua
2020-05-20	201	676	877	43	185	228	Chihuahua
2020-05-21	207	625	832	47	166	213	Chihuahua
2020-05-22	214	668	882	45	181	226	Chihuahua
2020-05-23	146	605	751	44	133	177	Chihuahua
2020-05-24	190	645	835	56	180	236	Chihuahua
2020-05-25	195	687	882	59	175	234	Chihuahua
2020-05-26	209	687	896	61	188	249	Chihuahua
2020-05-27	193	639	832	57	176	233	Chihuahua
2020-05-28	195	702	897	54	180	234	Chihuahua
2020-05-29	217	739	956	53	185	238	Chihuahua
2020-05-30	213	753	966	58	191	249	Chihuahua
2020-05-31	212	708	920	51	187	238	Chihuahua
2020-06-01	158	656	814	35	143	178	Chihuahua
2020-06-02	207	599	806	54	176	230	Chihuahua
2020-06-03	210	562	772	54	187	241	Chihuahua
2020-06-04	193	566	759	58	190	248	Chihuahua
2020-06-05	187	560	747	64	189	253	Chihuahua
2020-06-06	178	566	744	66	183	249	Chihuahua
2020-06-07	176	553	729	67	174	241	Chihuahua
2020-06-08	172	573	745	62	176	238	Chihuahua
2020-06-09	187	603	790	63	196	259	Chihuahua
2020-06-10	170	588	758	65	189	254	Chihuahua
2020-06-11	170	617	787	62	192	254	Chihuahua
2020-06-12	163	593	756	60	203	263	Chihuahua
2020-06-13	156	621	777	63	206	269	Chihuahua
2020-06-14	153	598	751	63	200	263	Chihuahua
2020-06-15	167	608	775	60	200	260	Chihuahua
2020-06-16	156	592	748	60	199	259	Chihuahua
2020-06-17	137	621	758	53	199	252	Chihuahua
2020-06-18	143	623	766	52	194	246	Chihuahua
2020-06-19	162	661	823	49	199	248	Chihuahua
2020-06-20	127	573	700	35	172	207	Chihuahua
2020-06-21	162	684	846	43	212	255	Chihuahua
2020-06-22	186	680	866	43	216	259	Chihuahua
2020-06-23	153	663	816	38	203	241	Chihuahua
2020-06-24	163	682	845	36	215	251	Chihuahua
2020-06-25	151	672	823	39	201	240	Chihuahua
2020-06-26	162	647	809	37	196	233	Chihuahua
2020-06-27	181	681	862	42	196	238	Chihuahua
2020-06-28	173	668	841	44	192	236	Chihuahua
2020-06-29	186	663	849	39	186	225	Chihuahua
2020-06-30	183	666	849	41	194	235	Chihuahua
2020-07-01	171	666	837	46	185	231	Chihuahua
2020-07-02	181	702	883	37	193	230	Chihuahua
2020-07-03	219	753	972	38	202	240	Chihuahua
2020-07-04	204	757	961	43	186	229	Chihuahua
2020-07-05	192	767	959	40	202	242	Chihuahua
2020-07-06	206	758	964	44	199	243	Chihuahua
2020-07-07	204	775	979	38	209	247	Chihuahua
2020-07-08	196	780	976	43	208	251	Chihuahua
2020-07-09	193	771	964	41	208	249	Chihuahua
2020-07-10	194	754	948	51	203	254	Chihuahua
2020-07-11	167	633	800	44	159	203	Chihuahua
2020-07-12	201	763	964	48	206	254	Chihuahua
2020-07-13	208	754	962	47	205	252	Chihuahua
2020-07-14	217	742	959	45	197	242	Chihuahua
2020-07-15	220	744	964	49	198	247	Chihuahua
2020-07-16	208	753	961	50	194	244	Chihuahua
2020-07-17	202	753	955	55	194	249	Chihuahua
2020-07-18	200	765	965	60	194	254	Chihuahua
2020-07-19	185	735	920	63	203	266	Chihuahua
2020-07-20	185	734	919	60	180	240	Chihuahua
2020-07-21	179	682	861	57	195	252	Chihuahua
2020-07-22	206	656	862	60	188	248	Chihuahua
2020-07-23	205	676	881	54	189	243	Chihuahua
2020-07-24	213	678	891	50	193	243	Chihuahua
2020-07-25	210	661	871	53	193	246	Chihuahua
2020-07-26	209	684	893	62	184	246	Chihuahua
2020-07-27	198	691	889	64	183	247	Chihuahua
2020-07-28	197	688	885	65	194	259	Chihuahua
2020-07-29	202	629	831	61	187	248	Chihuahua
2020-07-30	188	667	855	53	203	256	Chihuahua
2020-07-31	230	652	882	53	207	260	Chihuahua
2020-08-01	214	673	887	52	207	259	Chihuahua
2020-08-02	213	668	881	55	212	267	Chihuahua
2020-08-03	200	658	858	60	216	276	Chihuahua
2020-08-04	197	669	866	58	215	273	Chihuahua
2020-08-05	195	654	849	49	200	249	Chihuahua
2020-08-06	199	687	886	41	215	256	Chihuahua
2020-08-07	178	692	870	46	216	262	Chihuahua
2020-08-08	170	706	876	42	218	260	Chihuahua
2020-08-09	170	701	871	48	219	267	Chihuahua
2020-08-10	175	706	881	43	217	260	Chihuahua
2020-08-11	180	689	869	42	230	272	Chihuahua
2020-08-12	183	690	873	42	239	281	Chihuahua
2020-08-13	184	699	883	38	226	264	Chihuahua
2020-08-14	189	683	872	43	229	272	Chihuahua
2020-08-15	191	690	881	43	229	272	Chihuahua
2020-08-16	182	702	884	44	230	274	Chihuahua
2020-08-17	185	695	880	46	221	267	Chihuahua
2020-08-18	168	696	864	45	218	263	Chihuahua
2020-08-19	157	661	818	44	210	254	Chihuahua
2020-08-20	175	620	795	45	224	269	Chihuahua
2020-08-21	164	627	791	44	209	253	Chihuahua
2020-08-22	167	612	779	48	199	247	Chihuahua
2020-08-23	175	579	754	59	195	254	Chihuahua
2020-08-24	192	574	766	57	198	255	Chihuahua
2020-08-25	193	596	789	53	206	259	Chihuahua
2020-08-26	176	585	761	45	178	223	Chihuahua
2020-08-27	201	592	793	53	198	251	Chihuahua
2020-08-28	195	593	788	55	205	260	Chihuahua
2020-08-29	202	596	798	53	203	256	Chihuahua
2020-08-30	207	566	773	40	194	234	Chihuahua
2020-08-31	205	571	776	45	187	232	Chihuahua
2020-09-01	208	602	810	52	195	247	Chihuahua
2020-09-02	195	601	796	52	192	244	Chihuahua
2020-09-03	188	584	772	50	197	247	Chihuahua
2020-09-04	196	608	804	49	193	242	Chihuahua
2020-09-05	202	607	809	46	197	243	Chihuahua
2020-09-06	213	552	765	48	191	239	Chihuahua
2020-04-01	89	0	89	52	27	79	Ciudad de México
2020-04-02	121	0	121	59	39	98	Ciudad de México
2020-04-03	129	166	295	25	43	68	Ciudad de México
2020-04-04	280	337	617	47	82	129	Ciudad de México
2020-04-05	269	327	596	74	84	158	Ciudad de México
2020-04-06	246	304	550	73	83	156	Ciudad de México
2020-04-07	521	860	1,381	119	551	670	Ciudad de México
2020-04-08	455	683	1,138	109	511	620	Ciudad de México
2020-04-09	486	698	1,184	138	351	489	Ciudad de México
2020-04-10	366	750	1,116	107	347	454	Ciudad de México
2020-04-11	555	1000	1,555	166	375	541	Ciudad de México
2020-04-12	621	834	1,455	132	394	526	Ciudad de México
2020-04-13	594	909	1,503	153	392	545	Ciudad de México
2020-04-14	510	836	1,346	197	407	604	Ciudad de México
2020-04-15	508	806	1,314	201	430	631	Ciudad de México
2020-04-16	579	837	1,416	145	440	585	Ciudad de México
2020-04-17	611	946	1,557	225	435	660	Ciudad de México
2020-04-18	691	972	1,663	228	434	662	Ciudad de México
2020-04-19	762	986	1,748	233	458	691	Ciudad de México
2020-04-20	698	855	1,553	121	438	559	Ciudad de México
2020-04-21	903	1008	1,911	289	565	854	Ciudad de México
2020-04-22	808	974	1,782	212	868	1,080	Ciudad de México
2020-04-23	984	840	1,824	261	848	1,109	Ciudad de México
2020-04-24	942	988	1,930	310	848	1,158	Ciudad de México
2020-04-25	931	1062	1,993	329	854	1,183	Ciudad de México
2020-04-26	1053	981	2,034	377	815	1,192	Ciudad de México
2020-04-27	1307	884	2,191	461	867	1,328	Ciudad de México
2020-04-28	1458	960	2,418	487	461	948	Ciudad de México
2020-04-29	1664	970	2,634	499	379	878	Ciudad de México
2020-04-30	1783	841	2,624	528	340	868	Ciudad de México
2020-05-01	2056	960	3,016	566	320	886	Ciudad de México
2020-05-02	2129	1109	3,238	551	388	939	Ciudad de México
2020-05-03	1925	856	2,781	570	362	932	Ciudad de México
2020-05-04	1951	803	2,754	524	374	898	Ciudad de México
2020-05-05	2179	870	3,049	588	413	1,001	Ciudad de México
2020-05-06	2234	973	3,207	611	350	961	Ciudad de México
2020-05-07	2263	784	3,047	583	351	934	Ciudad de México
2020-05-08	2487	929	3,416	637	434	1,071	Ciudad de México
2020-05-09	2510	888	3,398	584	348	932	Ciudad de México
2020-05-10	2337	861	3,198	577	330	907	Ciudad de México
2020-05-11	2757	1166	3,923	648	540	1,188	Ciudad de México
2020-05-12	2864	1222	4,086	691	527	1,218	Ciudad de México
2020-05-13	2777	1040	3,817	730	538	1,268	Ciudad de México
2020-05-14	2887	911	3,798	741	429	1,170	Ciudad de México
2020-05-15	3011	1117	4,128	705	557	1,262	Ciudad de México
2020-05-16	3026	899	3,925	749	343	1,092	Ciudad de México
2020-05-17	3055	927	3,982	741	389	1,130	Ciudad de México
2020-05-18	3057	1079	4,136	771	403	1,174	Ciudad de México
2020-05-19	3105	1182	4,287	773	508	1,281	Ciudad de México
2020-05-20	3021	1163	4,184	901	508	1,409	Ciudad de México
2020-05-21	3060	1204	4,264	870	531	1,401	Ciudad de México
2020-05-22	3035	1395	4,430	902	645	1,547	Ciudad de México
2020-05-23	2787	1117	3,904	824	410	1,234	Ciudad de México
2020-05-24	2701	1014	3,715	763	416	1,179	Ciudad de México
2020-05-25	2887	1413	4,300	821	664	1,485	Ciudad de México
2020-05-26	3013	1291	4,304	929	613	1,542	Ciudad de México
2020-05-27	2932	1409	4,341	888	654	1,542	Ciudad de México
2020-05-28	2916	1295	4,211	877	629	1,506	Ciudad de México
2020-05-29	2911	1233	4,144	866	673	1,539	Ciudad de México
2020-05-30	2773	1155	3,928	810	690	1,500	Ciudad de México
2020-05-31	2681	688	3,369	769	442	1,211	Ciudad de México
2020-06-01	2836	722	3,558	852	437	1,289	Ciudad de México
2020-06-02	2965	1031	3,996	872	656	1,528	Ciudad de México
2020-06-03	2946	650	3,596	877	455	1,332	Ciudad de México
2020-06-04	2947	749	3,696	856	556	1,412	Ciudad de México
2020-06-05	2888	760	3,648	829	510	1,339	Ciudad de México
2020-06-06	2668	674	3,342	685	424	1,109	Ciudad de México
2020-06-07	2749	775	3,524	754	468	1,222	Ciudad de México
2020-06-08	2841	780	3,621	828	508	1,336	Ciudad de México
2020-06-09	2942	787	3,729	807	505	1,312	Ciudad de México
2020-06-10	2932	828	3,760	836	537	1,373	Ciudad de México
2020-06-11	2971	830	3,801	848	514	1,362	Ciudad de México
2020-06-12	2817	823	3,640	758	547	1,305	Ciudad de México
2020-06-13	2665	913	3,578	803	476	1,279	Ciudad de México
2020-06-14	2584	985	3,569	768	496	1,264	Ciudad de México
2020-06-15	2759	1002	3,761	843	539	1,382	Ciudad de México
2020-06-16	2672	942	3,614	785	537	1,322	Ciudad de México
2020-06-17	2592	869	3,461	768	541	1,309	Ciudad de México
2020-06-18	2641	1125	3,766	766	590	1,356	Ciudad de México
2020-06-19	2761	1222	3,983	811	668	1,479	Ciudad de México
2020-06-20	2461	1115	3,576	696	634	1,330	Ciudad de México
2020-06-21	2447	1107	3,554	637	530	1,167	Ciudad de México
2020-06-22	2600	1392	3,992	848	734	1,582	Ciudad de México
2020-06-23	2558	1168	3,726	733	621	1,354	Ciudad de México
2020-06-24	2645	1416	4,061	771	750	1,521	Ciudad de México
2020-06-25	2513	1445	3,958	804	704	1,508	Ciudad de México
2020-06-26	2483	1407	3,890	762	657	1,419	Ciudad de México
2020-06-27	2221	1392	3,613	695	598	1,293	Ciudad de México
2020-06-28	2141	1363	3,504	650	544	1,194	Ciudad de México
2020-06-29	2331	1402	3,733	778	619	1,397	Ciudad de México
2020-06-30	2503	1999	4,502	680	646	1,326	Ciudad de México
2020-07-01	2562	1632	4,194	641	666	1,307	Ciudad de México
2020-07-02	2415	1856	4,271	687	668	1,355	Ciudad de México
2020-07-03	2573	2031	4,604	785	706	1,491	Ciudad de México
2020-07-04	2379	1917	4,296	658	660	1,318	Ciudad de México
2020-07-05	2241	1754	3,995	593	550	1,143	Ciudad de México
2020-07-06	2520	2052	4,572	754	713	1,467	Ciudad de México
2020-07-07	2489	2019	4,508	669	633	1,302	Ciudad de México
2020-07-08	2521	2074	4,595	739	743	1,482	Ciudad de México
2020-07-09	2333	2012	4,345	693	767	1,460	Ciudad de México
2020-07-10	2399	2047	4,446	717	776	1,493	Ciudad de México
2020-07-11	2141	1992	4,133	551	546	1,097	Ciudad de México
2020-07-12	2293	2054	4,347	680	711	1,391	Ciudad de México
2020-07-13	2348	2239	4,587	709	770	1,479	Ciudad de México
2020-07-14	2318	2131	4,449	680	753	1,433	Ciudad de México
2020-07-15	2442	2217	4,659	698	806	1,504	Ciudad de México
2020-07-16	2318	2130	4,448	690	778	1,468	Ciudad de México
2020-07-17	2278	2165	4,443	639	805	1,444	Ciudad de México
2020-07-18	2241	2132	4,373	641	779	1,420	Ciudad de México
2020-07-19	2480	2179	4,659	702	800	1,502	Ciudad de México
2020-07-20	2422	2199	4,621	674	812	1,486	Ciudad de México
2020-07-21	2398	2133	4,531	698	818	1,516	Ciudad de México
2020-07-22	2328	2026	4,354	658	749	1,407	Ciudad de México
2020-07-23	2384	1967	4,351	659	741	1,400	Ciudad de México
2020-07-24	2380	2177	4,557	657	776	1,433	Ciudad de México
2020-07-25	2398	2038	4,436	691	731	1,422	Ciudad de México
2020-07-26	2233	2005	4,238	590	621	1,211	Ciudad de México
2020-07-27	2343	2161	4,504	685	758	1,443	Ciudad de México
2020-07-28	2318	1970	4,288	589	634	1,223	Ciudad de México
2020-07-29	2289	2069	4,358	656	764	1,420	Ciudad de México
2020-07-30	2306	2188	4,494	726	760	1,486	Ciudad de México
2020-07-31	2217	2135	4,352	723	743	1,466	Ciudad de México
2020-08-01	2008	2008	4,016	658	674	1,332	Ciudad de México
2020-08-02	2007	2074	4,081	645	651	1,296	Ciudad de México
2020-08-03	2107	1903	4,010	705	1089	1,794	Ciudad de México
2020-08-04	2169	2345	4,514	727	828	1,555	Ciudad de México
2020-08-05	2266	2369	4,635	752	810	1,562	Ciudad de México
2020-08-06	2184	2338	4,522	702	807	1,509	Ciudad de México
2020-08-07	2142	2314	4,456	699	845	1,544	Ciudad de México
2020-08-08	1897	2262	4,159	531	642	1,173	Ciudad de México
2020-08-09	1895	2295	4,190	560	660	1,220	Ciudad de México
2020-08-10	2055	2468	4,523	718	810	1,528	Ciudad de México
2020-08-11	2062	2281	4,343	676	803	1,479	Ciudad de México
2020-08-12	2001	2457	4,458	638	822	1,460	Ciudad de México
2020-08-13	1929	2372	4,301	638	825	1,463	Ciudad de México
2020-08-14	1892	2503	4,395	633	862	1,495	Ciudad de México
2020-08-15	1766	2239	4,005	524	699	1,223	Ciudad de México
2020-08-16	1949	2426	4,375	638	832	1,470	Ciudad de México
2020-08-17	1999	2443	4,442	680	859	1,539	Ciudad de México
2020-08-18	1957	2320	4,277	613	856	1,469	Ciudad de México
2020-08-19	2089	2396	4,485	655	889	1,544	Ciudad de México
2020-08-20	2039	2438	4,477	641	896	1,537	Ciudad de México
2020-08-21	1881	2450	4,331	606	877	1,483	Ciudad de México
2020-08-22	1739	2330	4,069	568	830	1,398	Ciudad de México
2020-08-23	1914	2461	4,375	653	843	1,496	Ciudad de México
2020-08-24	1895	2399	4,294	643	848	1,491	Ciudad de México
2020-08-25	1888	2262	4,150	621	860	1,481	Ciudad de México
2020-08-26	2074	2372	4,446	651	858	1,509	Ciudad de México
2020-08-27	1981	2228	4,209	576	826	1,402	Ciudad de México
2020-08-28	2051	2372	4,423	668	868	1,536	Ciudad de México
2020-08-29	1913	2197	4,110	512	721	1,233	Ciudad de México
2020-08-30	1933	2294	4,227	620	772	1,392	Ciudad de México
2020-08-31	2042	2337	4,379	661	853	1,514	Ciudad de México
2020-09-01	2054	2313	4,367	615	856	1,471	Ciudad de México
2020-09-02	1964	2240	4,204	574	836	1,410	Ciudad de México
2020-09-03	2105	2429	4,534	661	802	1,463	Ciudad de México
2020-09-04	1912	2228	4,140	572	800	1,372	Ciudad de México
2020-09-05	1851	2272	4,123	562	754	1,316	Ciudad de México
2020-09-06	1814	2268	4,082	542	661	1,203	Ciudad de México
2020-04-07	12	70	82	3	101	104	Coahuila
2020-04-08	14	74	88	2	105	107	Coahuila
2020-04-09	19	76	95	2	96	98	Coahuila
2020-04-10	23	85	108	4	122	126	Coahuila
2020-04-11	27	128	155	8	142	150	Coahuila
2020-04-12	34	117	151	9	139	148	Coahuila
2020-04-13	40	145	185	8	127	135	Coahuila
2020-04-14	37	142	179	7	127	134	Coahuila
2020-04-15	37	122	159	8	123	131	Coahuila
2020-04-16	39	110	149	9	116	125	Coahuila
2020-04-17	43	125	168	9	128	137	Coahuila
2020-04-18	38	129	167	10	136	146	Coahuila
2020-04-19	38	101	139	15	121	136	Coahuila
2020-04-20	42	161	203	14	139	153	Coahuila
2020-04-21	45	187	232	13	227	240	Coahuila
2020-04-22	44	244	288	12	170	182	Coahuila
2020-04-23	39	254	293	7	171	178	Coahuila
2020-04-24	45	234	279	6	171	177	Coahuila
2020-04-25	38	219	257	10	142	152	Coahuila
2020-04-26	37	251	288	11	141	152	Coahuila
2020-04-27	59	309	368	13	179	192	Coahuila
2020-04-28	52	325	377	12	94	106	Coahuila
2020-04-29	34	287	321	12	117	129	Coahuila
2020-04-30	54	297	351	9	123	132	Coahuila
2020-05-01	51	295	346	12	127	139	Coahuila
2020-05-02	50	313	363	9	97	106	Coahuila
2020-05-03	39	272	311	8	98	106	Coahuila
2020-05-04	32	314	346	10	96	106	Coahuila
2020-05-05	31	287	318	9	127	136	Coahuila
2020-05-06	23	274	297	9	102	111	Coahuila
2020-05-07	25	285	310	10	127	137	Coahuila
2020-05-08	31	238	269	7	124	131	Coahuila
2020-05-09	32	274	306	9	98	107	Coahuila
2020-05-10	33	233	266	9	97	106	Coahuila
2020-05-11	40	280	320	7	139	146	Coahuila
2020-05-12	45	274	319	6	106	112	Coahuila
2020-05-13	40	269	309	8	98	106	Coahuila
2020-05-14	43	268	311	9	94	103	Coahuila
2020-05-15	53	269	322	9	129	138	Coahuila
2020-05-16	42	230	272	10	91	101	Coahuila
2020-05-17	54	276	330	12	103	115	Coahuila
2020-05-18	64	275	339	14	129	143	Coahuila
2020-05-19	62	284	346	15	133	148	Coahuila
2020-05-20	54	283	337	16	101	117	Coahuila
2020-05-21	49	280	329	16	100	116	Coahuila
2020-05-22	52	279	331	14	95	109	Coahuila
2020-05-23	61	287	348	17	95	112	Coahuila
2020-05-24	66	270	336	18	101	119	Coahuila
2020-05-25	70	293	363	16	97	113	Coahuila
2020-05-26	70	270	340	20	158	178	Coahuila
2020-05-27	70	284	354	19	139	158	Coahuila
2020-05-28	68	267	335	19	152	171	Coahuila
2020-05-29	79	257	336	16	165	181	Coahuila
2020-05-30	67	256	323	20	149	169	Coahuila
2020-05-31	81	270	351	20	133	153	Coahuila
2020-06-01	89	256	345	22	133	155	Coahuila
2020-06-02	99	253	352	21	99	120	Coahuila
2020-06-03	92	264	356	27	134	161	Coahuila
2020-06-04	98	261	359	33	134	167	Coahuila
2020-06-05	103	263	366	30	127	157	Coahuila
2020-06-06	93	256	349	30	100	130	Coahuila
2020-06-07	109	240	349	28	139	167	Coahuila
2020-06-08	120	247	367	32	128	160	Coahuila
2020-06-09	124	237	361	32	122	154	Coahuila
2020-06-10	127	254	381	31	129	160	Coahuila
2020-06-11	138	244	382	31	129	160	Coahuila
2020-06-12	135	251	386	32	132	164	Coahuila
2020-06-13	155	228	383	29	128	157	Coahuila
2020-06-14	167	268	435	34	128	162	Coahuila
2020-06-15	159	255	414	36	110	146	Coahuila
2020-06-16	144	268	412	35	89	124	Coahuila
2020-06-17	164	257	421	39	139	178	Coahuila
2020-06-18	179	252	431	38	126	164	Coahuila
2020-06-19	177	247	424	45	124	169	Coahuila
2020-06-20	160	219	379	39	126	165	Coahuila
2020-06-21	171	259	430	35	109	144	Coahuila
2020-06-22	210	254	464	42	123	165	Coahuila
2020-06-23	199	256	455	39	141	180	Coahuila
2020-06-24	189	255	444	39	146	185	Coahuila
2020-06-25	203	260	463	45	144	189	Coahuila
2020-06-26	205	256	461	48	142	190	Coahuila
2020-06-27	189	257	446	45	112	157	Coahuila
2020-06-28	200	262	462	47	134	181	Coahuila
2020-06-29	217	257	474	49	135	184	Coahuila
2020-06-30	231	212	443	53	129	182	Coahuila
2020-07-01	248	225	473	53	138	191	Coahuila
2020-07-02	244	233	477	52	119	171	Coahuila
2020-07-03	277	234	511	46	148	194	Coahuila
2020-07-04	270	220	490	46	144	190	Coahuila
2020-07-05	280	217	497	47	139	186	Coahuila
2020-07-06	295	204	499	45	145	190	Coahuila
2020-07-07	309	204	513	53	145	198	Coahuila
2020-07-08	303	201	504	50	114	164	Coahuila
2020-07-09	310	276	586	54	138	192	Coahuila
2020-07-10	323	262	585	60	130	190	Coahuila
2020-07-11	321	281	602	58	127	185	Coahuila
2020-07-12	314	301	615	58	130	188	Coahuila
2020-07-13	330	268	598	59	132	191	Coahuila
2020-07-14	311	276	587	66	119	185	Coahuila
2020-07-15	322	278	600	55	107	162	Coahuila
2020-07-16	340	278	618	56	133	189	Coahuila
2020-07-17	352	285	637	68	139	207	Coahuila
2020-07-18	352	232	584	60	107	167	Coahuila
2020-07-19	388	225	613	72	116	188	Coahuila
2020-07-20	372	233	605	77	117	194	Coahuila
2020-07-21	394	221	615	86	110	196	Coahuila
2020-07-22	396	225	621	79	122	201	Coahuila
2020-07-23	391	222	613	79	122	201	Coahuila
2020-07-24	440	200	640	76	136	212	Coahuila
2020-07-25	442	194	636	78	118	196	Coahuila
2020-07-26	417	188	605	75	113	188	Coahuila
2020-07-27	449	182	631	87	110	197	Coahuila
2020-07-28	453	199	652	88	104	192	Coahuila
2020-07-29	457	221	678	95	110	205	Coahuila
2020-07-30	479	208	687	85	114	199	Coahuila
2020-07-31	435	237	672	92	112	204	Coahuila
2020-08-01	454	226	680	91	110	201	Coahuila
2020-08-02	427	220	647	88	102	190	Coahuila
2020-08-03	436	192	628	78	88	166	Coahuila
2020-08-04	458	242	700	95	118	213	Coahuila
2020-08-05	453	249	702	92	138	230	Coahuila
2020-08-06	475	244	719	91	147	238	Coahuila
2020-08-07	452	262	714	98	140	238	Coahuila
2020-08-08	433	265	698	105	144	249	Coahuila
2020-08-09	384	242	626	80	102	182	Coahuila
2020-08-10	400	276	676	91	117	208	Coahuila
2020-08-11	390	287	677	92	153	245	Coahuila
2020-08-12	410	298	708	87	160	247	Coahuila
2020-08-13	439	296	735	91	168	259	Coahuila
2020-08-14	405	314	719	89	170	259	Coahuila
2020-08-15	416	306	722	78	155	233	Coahuila
2020-08-16	409	328	737	76	162	238	Coahuila
2020-08-17	416	293	709	70	164	234	Coahuila
2020-08-18	406	330	736	67	179	246	Coahuila
2020-08-19	391	330	721	66	171	237	Coahuila
2020-08-20	377	344	721	74	158	232	Coahuila
2020-08-21	385	340	725	75	152	227	Coahuila
2020-08-22	351	389	740	76	156	232	Coahuila
2020-08-23	306	376	682	68	112	180	Coahuila
2020-08-24	364	395	759	82	167	249	Coahuila
2020-08-25	375	421	796	77	163	240	Coahuila
2020-08-26	393	427	820	78	164	242	Coahuila
2020-08-27	383	449	832	76	140	216	Coahuila
2020-08-28	374	461	835	80	152	232	Coahuila
2020-08-29	357	461	818	76	155	231	Coahuila
2020-08-30	351	533	884	77	167	244	Coahuila
2020-08-31	351	486	837	70	166	236	Coahuila
2020-09-01	375	490	865	64	168	232	Coahuila
2020-09-02	358	506	864	62	163	225	Coahuila
2020-09-03	316	450	766	63	125	188	Coahuila
2020-09-04	299	389	688	62	154	216	Coahuila
2020-09-05	327	497	824	75	161	236	Coahuila
2020-09-06	324	508	832	70	180	250	Coahuila
2020-04-07	1	31	32	0	34	34	Colima
2020-04-08	1	31	32	0	34	34	Colima
2020-04-09	1	199	200	0	33	33	Colima
2020-04-10	3	199	202	0	33	33	Colima
2020-04-11	1	66	67	0	34	34	Colima
2020-04-12	0	66	66	0	35	35	Colima
2020-04-13	0	66	66	0	35	35	Colima
2020-04-14	4	177	181	0	44	44	Colima
2020-04-15	1	66	67	0	33	33	Colima
2020-04-16	3	167	170	1	38	39	Colima
2020-04-17	4	166	170	1	36	37	Colima
2020-04-18	5	167	172	1	35	36	Colima
2020-04-19	3	166	169	2	37	39	Colima
2020-04-20	5	168	173	1	34	35	Colima
2020-04-21	7	193	200	1	141	142	Colima
2020-04-22	6	240	246	2	50	52	Colima
2020-04-23	8	199	207	2	46	48	Colima
2020-04-24	11	197	208	2	45	47	Colima
2020-04-25	12	197	209	2	43	45	Colima
2020-04-26	10	184	194	3	45	48	Colima
2020-04-27	9	227	236	1	45	46	Colima
2020-04-28	5	208	213	2	35	37	Colima
2020-04-29	2	180	182	4	36	40	Colima
2020-04-30	3	180	183	5	39	44	Colima
2020-05-01	4	178	182	6	38	44	Colima
2020-05-02	5	178	183	5	40	45	Colima
2020-05-03	11	178	189	5	38	43	Colima
2020-05-04	10	178	188	2	35	37	Colima
2020-05-05	8	178	186	3	37	40	Colima
2020-05-06	7	178	185	5	34	39	Colima
2020-05-07	9	171	180	6	32	38	Colima
2020-05-08	5	178	183	6	32	38	Colima
2020-05-09	8	178	186	6	33	39	Colima
2020-05-10	11	174	185	6	34	40	Colima
2020-05-11	8	176	184	6	33	39	Colima
2020-05-12	11	176	187	5	36	41	Colima
2020-05-13	11	175	186	5	36	41	Colima
2020-05-14	15	172	187	7	39	46	Colima
2020-05-15	19	174	193	6	35	41	Colima
2020-05-16	22	173	195	5	36	41	Colima
2020-05-17	21	175	196	6	34	40	Colima
2020-05-18	23	176	199	6	34	40	Colima
2020-05-19	22	176	198	7	35	42	Colima
2020-05-20	27	173	200	7	39	46	Colima
2020-05-21	23	175	198	8	36	44	Colima
2020-05-22	25	173	198	7	37	44	Colima
2020-05-23	32	172	204	8	36	44	Colima
2020-05-24	28	167	195	9	33	42	Colima
2020-05-25	30	173	203	7	47	54	Colima
2020-05-26	26	145	171	7	43	50	Colima
2020-05-27	28	85	113	6	44	50	Colima
2020-05-28	27	88	115	5	43	48	Colima
2020-05-29	31	83	114	6	45	51	Colima
2020-05-30	30	91	121	7	42	49	Colima
2020-05-31	30	91	121	8	41	49	Colima
2020-06-01	32	82	114	8	41	49	Colima
2020-06-02	33	80	113	10	40	50	Colima
2020-06-03	24	93	117	12	32	44	Colima
2020-06-04	26	91	117	11	35	46	Colima
2020-06-05	28	93	121	14	29	43	Colima
2020-06-06	27	93	120	14	29	43	Colima
2020-06-07	24	96	120	16	24	40	Colima
2020-06-08	26	90	116	14	31	45	Colima
2020-06-09	26	85	111	16	31	47	Colima
2020-06-10	29	84	113	14	29	43	Colima
2020-06-11	29	86	115	17	32	49	Colima
2020-06-12	28	87	115	17	32	49	Colima
2020-06-13	34	83	117	16	33	49	Colima
2020-06-14	36	85	121	13	37	50	Colima
2020-06-15	39	77	116	10	41	51	Colima
2020-06-16	37	80	117	10	39	49	Colima
2020-06-17	38	80	118	11	39	50	Colima
2020-06-18	42	74	116	12	39	51	Colima
2020-06-19	40	78	118	19	32	51	Colima
2020-06-20	43	77	120	18	28	46	Colima
2020-06-21	38	80	118	16	29	45	Colima
2020-06-22	57	68	125	18	31	49	Colima
2020-06-23	67	58	125	18	32	50	Colima
2020-06-24	66	57	123	19	38	57	Colima
2020-06-25	63	56	119	24	28	52	Colima
2020-06-26	58	62	120	24	24	48	Colima
2020-06-27	59	49	108	22	38	60	Colima
2020-06-28	51	45	96	30	29	59	Colima
2020-06-29	55	48	103	25	44	69	Colima
2020-06-30	50	48	98	27	47	74	Colima
2020-07-01	47	48	95	22	60	82	Colima
2020-07-02	43	52	95	24	57	81	Colima
2020-07-03	40	51	91	24	58	82	Colima
2020-07-04	43	45	88	25	59	84	Colima
2020-07-05	46	47	93	23	56	79	Colima
2020-07-06	54	39	93	20	61	81	Colima
2020-07-07	51	41	92	25	55	80	Colima
2020-07-08	64	34	98	21	56	77	Colima
2020-07-09	53	37	90	24	60	84	Colima
2020-07-10	54	31	85	28	58	86	Colima
2020-07-11	52	22	74	31	49	80	Colima
2020-07-12	58	57	115	28	44	72	Colima
2020-07-13	59	52	111	28	50	78	Colima
2020-07-14	51	59	110	29	48	77	Colima
2020-07-15	61	48	109	27	46	73	Colima
2020-07-16	61	42	103	27	53	80	Colima
2020-07-17	52	40	92	32	51	83	Colima
2020-07-18	54	36	90	38	48	86	Colima
2020-07-19	65	36	101	44	38	82	Colima
2020-07-20	83	41	124	36	46	82	Colima
2020-07-21	91	49	140	33	49	82	Colima
2020-07-22	95	45	140	38	47	85	Colima
2020-07-23	95	48	143	37	52	89	Colima
2020-07-24	99	51	150	39	48	87	Colima
2020-07-25	92	43	135	35	48	83	Colima
2020-07-26	104	56	160	39	33	72	Colima
2020-07-27	97	62	159	40	31	71	Colima
2020-07-28	106	61	167	44	27	71	Colima
2020-07-29	103	57	160	44	35	79	Colima
2020-07-30	97	46	143	46	43	89	Colima
2020-07-31	97	52	149	45	35	80	Colima
2020-08-01	86	58	144	43	43	86	Colima
2020-08-02	83	46	129	45	41	86	Colima
2020-08-03	78	67	145	52	35	87	Colima
2020-08-04	82	87	169	48	40	88	Colima
2020-08-05	83	84	167	49	34	83	Colima
2020-08-06	85	81	166	51	38	89	Colima
2020-08-07	101	74	175	55	33	88	Colima
2020-08-08	106	68	174	61	31	92	Colima
2020-08-09	99	47	146	57	27	84	Colima
2020-08-10	116	69	185	54	26	80	Colima
2020-08-11	115	68	183	52	26	78	Colima
2020-08-12	117	73	190	43	27	70	Colima
2020-08-13	101	53	154	40	29	69	Colima
2020-08-14	102	86	188	38	36	74	Colima
2020-08-15	99	95	194	44	31	75	Colima
2020-08-16	101	96	197	41	32	73	Colima
2020-08-17	107	80	187	51	31	82	Colima
2020-08-18	106	77	183	49	44	93	Colima
2020-08-19	89	74	163	54	43	97	Colima
2020-08-20	93	70	163	54	44	98	Colima
2020-08-21	94	86	180	62	38	100	Colima
2020-08-22	108	82	190	61	39	100	Colima
2020-08-23	112	79	191	62	38	100	Colima
2020-08-24	129	66	195	54	45	99	Colima
2020-08-25	126	64	190	49	47	96	Colima
2020-08-26	102	81	183	46	37	83	Colima
2020-08-27	122	83	205	55	49	104	Colima
2020-08-28	114	89	203	54	49	103	Colima
2020-08-29	94	113	207	54	54	108	Colima
2020-08-30	90	102	192	52	43	95	Colima
2020-08-31	115	94	209	53	51	104	Colima
2020-09-01	100	97	197	49	59	108	Colima
2020-09-02	101	95	196	48	60	108	Colima
2020-09-03	94	101	195	48	62	110	Colima
2020-09-04	95	87	182	48	60	108	Colima
2020-09-05	89	82	171	52	52	104	Colima
2020-09-06	130	82	212	29	50	79	Colima
2020-04-07	3	36	39	1	50	51	Durango
2020-04-08	4	36	40	1	54	55	Durango
2020-04-09	7	44	51	0	31	31	Durango
2020-04-10	18	44	62	0	67	67	Durango
2020-04-11	15	44	59	0	68	68	Durango
2020-04-12	14	44	58	0	72	72	Durango
2020-04-13	14	44	58	0	72	72	Durango
2020-04-14	14	44	58	0	73	73	Durango
2020-04-15	0	6	6	0	8	8	Durango
2020-04-16	11	44	55	1	71	72	Durango
2020-04-17	12	44	56	0	78	78	Durango
2020-04-18	12	43	55	0	77	77	Durango
2020-04-19	11	44	55	0	75	75	Durango
2020-04-20	11	52	63	0	72	72	Durango
2020-04-21	9	78	87	0	97	97	Durango
2020-04-22	22	79	101	2	68	70	Durango
2020-04-23	20	99	119	5	81	86	Durango
2020-04-24	22	98	120	6	82	88	Durango
2020-04-25	23	98	121	5	82	87	Durango
2020-04-26	17	85	102	3	70	73	Durango
2020-04-27	9	99	108	4	81	85	Durango
2020-04-28	9	112	121	4	71	75	Durango
2020-04-29	16	112	128	5	71	76	Durango
2020-04-30	16	111	127	4	72	76	Durango
2020-05-01	17	110	127	5	78	83	Durango
2020-05-02	14	83	97	3	49	52	Durango
2020-05-03	15	83	98	2	53	55	Durango
2020-05-04	19	110	129	3	77	80	Durango
2020-05-05	18	97	115	2	73	75	Durango
2020-05-06	19	111	130	5	85	90	Durango
2020-05-07	25	112	137	6	84	90	Durango
2020-05-08	19	121	140	6	84	90	Durango
2020-05-09	23	143	166	4	80	84	Durango
2020-05-10	17	128	145	4	98	102	Durango
2020-05-11	15	109	124	5	73	78	Durango
2020-05-12	17	159	176	6	83	89	Durango
2020-05-13	18	147	165	6	69	75	Durango
2020-05-14	26	162	188	7	80	87	Durango
2020-05-15	23	148	171	6	68	74	Durango
2020-05-16	27	147	174	7	69	76	Durango
2020-05-17	29	148	177	6	61	67	Durango
2020-05-18	18	162	180	7	81	88	Durango
2020-05-19	14	199	213	6	69	75	Durango
2020-05-20	23	202	225	8	93	101	Durango
2020-05-21	21	209	230	10	85	95	Durango
2020-05-22	30	210	240	9	84	93	Durango
2020-05-23	29	182	211	6	60	66	Durango
2020-05-24	45	260	305	9	73	82	Durango
2020-05-25	61	211	272	9	75	84	Durango
2020-05-26	42	238	280	10	80	90	Durango
2020-05-27	23	256	279	12	93	105	Durango
2020-05-28	25	253	278	13	87	100	Durango
2020-05-29	32	249	281	10	95	105	Durango
2020-05-30	31	237	268	10	99	109	Durango
2020-05-31	35	194	229	12	88	100	Durango
2020-06-01	47	236	283	11	93	104	Durango
2020-06-02	49	237	286	9	97	106	Durango
2020-06-03	39	236	275	9	92	101	Durango
2020-06-04	40	235	275	8	92	100	Durango
2020-06-05	37	232	269	9	92	101	Durango
2020-06-06	49	234	283	10	91	101	Durango
2020-06-07	55	189	244	9	83	92	Durango
2020-06-08	71	231	302	10	88	98	Durango
2020-06-09	70	234	304	14	83	97	Durango
2020-06-10	55	245	300	17	81	98	Durango
2020-06-11	70	213	283	16	76	92	Durango
2020-06-12	55	208	263	13	76	89	Durango
2020-06-13	59	218	277	12	75	87	Durango
2020-06-14	57	218	275	12	81	93	Durango
2020-06-15	64	213	277	17	77	94	Durango
2020-06-16	78	198	276	19	78	97	Durango
2020-06-17	61	209	270	25	76	101	Durango
2020-06-18	67	214	281	23	73	96	Durango
2020-06-19	59	211	270	23	75	98	Durango
2020-06-20	58	193	251	24	62	86	Durango
2020-06-21	56	235	291	23	80	103	Durango
2020-06-22	67	220	287	22	76	98	Durango
2020-06-23	65	229	294	27	73	100	Durango
2020-06-24	65	237	302	27	78	105	Durango
2020-06-25	54	242	296	30	76	106	Durango
2020-06-26	54	233	287	29	81	110	Durango
2020-06-27	65	223	288	26	80	106	Durango
2020-06-28	57	233	290	27	85	112	Durango
2020-06-29	74	227	301	25	90	115	Durango
2020-06-30	78	225	303	31	85	116	Durango
2020-07-01	78	217	295	30	86	116	Durango
2020-07-02	72	229	301	28	87	115	Durango
2020-07-03	87	223	310	28	87	115	Durango
2020-07-04	90	212	302	30	88	118	Durango
2020-07-05	90	208	298	29	78	107	Durango
2020-07-06	97	196	293	30	84	114	Durango
2020-07-07	87	203	290	29	80	109	Durango
2020-07-08	76	206	282	33	77	110	Durango
2020-07-09	78	206	284	32	81	113	Durango
2020-07-10	88	198	286	35	76	111	Durango
2020-07-11	85	206	291	36	71	107	Durango
2020-07-12	87	200	287	32	81	113	Durango
2020-07-13	85	202	287	31	78	109	Durango
2020-07-14	86	216	302	26	89	115	Durango
2020-07-15	76	215	291	27	92	119	Durango
2020-07-16	86	214	300	26	92	118	Durango
2020-07-17	84	211	295	28	85	113	Durango
2020-07-18	83	207	290	29	88	117	Durango
2020-07-19	88	201	289	27	90	117	Durango
2020-07-20	87	200	287	25	90	115	Durango
2020-07-21	92	199	291	26	90	116	Durango
2020-07-22	83	205	288	31	86	117	Durango
2020-07-23	91	210	301	32	80	112	Durango
2020-07-24	85	212	297	35	87	122	Durango
2020-07-25	89	215	304	36	80	116	Durango
2020-07-26	96	200	296	33	79	112	Durango
2020-07-27	95	219	314	32	77	109	Durango
2020-07-28	97	206	303	34	76	110	Durango
2020-07-29	99	202	301	38	69	107	Durango
2020-07-30	103	197	300	32	69	101	Durango
2020-07-31	97	199	296	39	65	104	Durango
2020-08-01	86	204	290	40	67	107	Durango
2020-08-02	89	202	291	38	69	107	Durango
2020-08-03	104	209	313	33	72	105	Durango
2020-08-04	108	206	314	34	67	101	Durango
2020-08-05	98	204	302	32	73	105	Durango
2020-08-06	89	210	299	31	77	108	Durango
2020-08-07	99	209	308	28	79	107	Durango
2020-08-08	91	209	300	28	78	106	Durango
2020-08-09	92	214	306	27	82	109	Durango
2020-08-10	80	227	307	23	86	109	Durango
2020-08-11	97	234	331	20	67	87	Durango
2020-08-12	98	231	329	25	63	88	Durango
2020-08-13	107	218	325	30	58	88	Durango
2020-08-14	107	228	335	32	60	92	Durango
2020-08-15	112	221	333	30	63	93	Durango
2020-08-16	100	235	335	33	63	96	Durango
2020-08-17	96	208	304	35	85	120	Durango
2020-08-18	98	215	313	27	81	108	Durango
2020-08-19	100	208	308	32	52	84	Durango
2020-08-20	95	206	301	31	64	95	Durango
2020-08-21	98	199	297	34	57	91	Durango
2020-08-22	93	171	264	36	58	94	Durango
2020-08-23	89	199	288	34	64	98	Durango
2020-08-24	102	195	297	38	59	97	Durango
2020-08-25	105	189	294	40	63	103	Durango
2020-08-26	102	183	285	39	57	96	Durango
2020-08-27	103	191	294	38	63	101	Durango
2020-08-28	110	193	303	34	60	94	Durango
2020-08-29	109	194	303	25	56	81	Durango
2020-08-30	109	176	285	34	55	89	Durango
2020-08-31	114	184	298	31	64	95	Durango
2020-09-01	121	187	308	34	53	87	Durango
2020-09-02	115	194	309	28	59	87	Durango
2020-09-03	109	192	301	30	55	85	Durango
2020-09-04	114	193	307	33	54	87	Durango
2020-09-05	107	213	320	31	60	91	Durango
2020-09-06	103	183	286	26	65	91	Durango
2020-03-31	1	0	1	1	12	13	Guanajuato
2020-04-01	1	0	1	1	12	13	Guanajuato
2020-04-02	2	0	2	1	11	12	Guanajuato
2020-04-04	2	10	12	1	22	23	Guanajuato
2020-04-05	2	10	12	1	22	23	Guanajuato
2020-04-06	2	11	13	1	22	23	Guanajuato
2020-04-07	6	231	237	4	90	94	Guanajuato
2020-04-08	6	224	230	2	84	86	Guanajuato
2020-04-09	14	241	255	3	95	98	Guanajuato
2020-04-10	11	228	239	0	82	82	Guanajuato
2020-04-11	12	240	252	2	97	99	Guanajuato
2020-04-12	13	226	239	1	88	89	Guanajuato
2020-04-13	11	239	250	2	99	101	Guanajuato
2020-04-14	11	239	250	2	99	101	Guanajuato
2020-04-15	10	238	248	2	102	104	Guanajuato
2020-04-16	12	238	250	1	102	103	Guanajuato
2020-04-17	33	529	562	9	280	289	Guanajuato
2020-04-18	20	442	462	13	273	286	Guanajuato
2020-04-19	25	424	449	12	268	280	Guanajuato
2020-04-20	25	419	444	13	316	329	Guanajuato
2020-04-21	26	510	536	14	394	408	Guanajuato
2020-04-22	29	594	623	16	395	411	Guanajuato
2020-04-23	40	583	623	14	391	405	Guanajuato
2020-04-24	40	567	607	10	378	388	Guanajuato
2020-04-25	53	574	627	17	372	389	Guanajuato
2020-04-26	60	585	645	16	377	393	Guanajuato
2020-04-27	62	584	646	15	378	393	Guanajuato
2020-04-28	66	580	646	20	334	354	Guanajuato
2020-04-29	62	707	769	17	329	346	Guanajuato
2020-04-30	56	683	739	25	325	350	Guanajuato
2020-05-01	53	833	886	23	308	331	Guanajuato
2020-05-02	50	800	850	24	315	339	Guanajuato
2020-05-03	57	795	852	26	284	310	Guanajuato
2020-05-04	65	809	874	18	289	307	Guanajuato
2020-05-05	66	701	767	20	287	307	Guanajuato
2020-05-06	56	708	764	25	286	311	Guanajuato
2020-05-07	68	688	756	22	286	308	Guanajuato
2020-05-08	62	676	738	23	277	300	Guanajuato
2020-05-09	75	651	726	25	273	298	Guanajuato
2020-05-10	82	704	786	29	298	327	Guanajuato
2020-05-11	81	705	786	33	293	326	Guanajuato
2020-05-12	79	770	849	32	317	349	Guanajuato
2020-05-13	77	761	838	34	308	342	Guanajuato
2020-05-14	75	760	835	39	304	343	Guanajuato
2020-05-15	79	744	823	38	294	332	Guanajuato
2020-05-16	95	762	857	35	294	329	Guanajuato
2020-05-17	107	749	856	32	290	322	Guanajuato
2020-05-18	106	757	863	35	290	325	Guanajuato
2020-05-19	121	751	872	41	285	326	Guanajuato
2020-05-20	126	751	877	44	278	322	Guanajuato
2020-05-21	138	765	903	42	277	319	Guanajuato
2020-05-22	146	773	919	44	612	656	Guanajuato
2020-05-23	140	776	916	43	658	701	Guanajuato
2020-05-24	149	755	904	38	640	678	Guanajuato
2020-05-25	154	756	910	39	678	717	Guanajuato
2020-05-26	158	758	916	44	656	700	Guanajuato
2020-05-27	153	762	915	45	677	722	Guanajuato
2020-05-28	149	760	909	51	679	730	Guanajuato
2020-05-29	142	749	891	51	676	727	Guanajuato
2020-05-30	149	738	887	53	678	731	Guanajuato
2020-05-31	155	574	729	46	563	609	Guanajuato
2020-06-01	185	549	734	51	684	735	Guanajuato
2020-06-02	189	534	723	50	609	659	Guanajuato
2020-06-03	204	502	706	57	673	730	Guanajuato
2020-06-04	222	495	717	62	661	723	Guanajuato
2020-06-05	222	494	716	65	620	685	Guanajuato
2020-06-06	255	469	724	73	619	692	Guanajuato
2020-06-07	261	459	720	66	606	672	Guanajuato
2020-06-08	263	438	701	80	648	728	Guanajuato
2020-06-09	290	549	839	73	545	618	Guanajuato
2020-06-10	279	434	713	75	614	689	Guanajuato
2020-06-11	307	448	755	102	642	744	Guanajuato
2020-06-12	332	422	754	98	649	747	Guanajuato
2020-06-13	310	392	702	104	631	735	Guanajuato
2020-06-14	311	386	697	109	578	687	Guanajuato
2020-06-15	313	354	667	105	571	676	Guanajuato
2020-06-16	370	404	774	119	623	742	Guanajuato
2020-06-17	365	358	723	98	531	629	Guanajuato
2020-06-18	401	403	804	120	628	748	Guanajuato
2020-06-19	425	386	811	115	630	745	Guanajuato
2020-06-20	420	358	778	114	626	740	Guanajuato
2020-06-21	432	371	803	111	638	749	Guanajuato
2020-06-22	417	371	788	111	617	728	Guanajuato
2020-06-23	439	371	810	102	630	732	Guanajuato
2020-06-24	485	363	848	112	631	743	Guanajuato
2020-06-25	500	358	858	118	628	746	Guanajuato
2020-06-26	474	353	827	136	620	756	Guanajuato
2020-06-27	461	319	780	149	587	736	Guanajuato
2020-06-28	503	348	851	147	607	754	Guanajuato
2020-06-29	517	345	862	164	572	736	Guanajuato
2020-06-30	538	369	907	176	588	764	Guanajuato
2020-07-01	530	365	895	174	585	759	Guanajuato
2020-07-02	567	373	940	171	580	751	Guanajuato
2020-07-03	539	430	969	169	591	760	Guanajuato
2020-07-04	543	410	953	164	591	755	Guanajuato
2020-07-05	600	369	969	163	605	768	Guanajuato
2020-07-06	615	370	985	149	598	747	Guanajuato
2020-07-07	645	326	971	158	615	773	Guanajuato
2020-07-08	654	351	1,005	147	616	763	Guanajuato
2020-07-09	645	397	1,042	165	600	765	Guanajuato
2020-07-10	629	393	1,022	148	596	744	Guanajuato
2020-07-11	640	371	1,011	160	606	766	Guanajuato
2020-07-12	610	411	1,021	165	583	748	Guanajuato
2020-07-13	646	355	1,001	166	605	771	Guanajuato
2020-07-14	628	381	1,009	184	570	754	Guanajuato
2020-07-15	620	389	1,009	177	588	765	Guanajuato
2020-07-16	613	389	1,002	178	600	778	Guanajuato
2020-07-17	606	384	990	175	584	759	Guanajuato
2020-07-18	605	424	1,029	182	545	727	Guanajuato
2020-07-19	573	379	952	159	486	645	Guanajuato
2020-07-20	647	410	1,057	160	602	762	Guanajuato
2020-07-21	646	441	1,087	167	614	781	Guanajuato
2020-07-22	622	428	1,050	166	600	766	Guanajuato
2020-07-23	630	457	1,087	156	627	783	Guanajuato
2020-07-24	622	450	1,072	157	610	767	Guanajuato
2020-07-25	602	455	1,057	146	615	761	Guanajuato
2020-07-26	636	428	1,064	156	589	745	Guanajuato
2020-07-27	617	429	1,046	153	611	764	Guanajuato
2020-07-28	658	458	1,116	137	630	767	Guanajuato
2020-07-29	646	461	1,107	151	641	792	Guanajuato
2020-07-30	637	444	1,081	150	617	767	Guanajuato
2020-07-31	655	474	1,129	175	631	806	Guanajuato
2020-08-01	631	508	1,139	180	623	803	Guanajuato
2020-08-02	628	510	1,138	178	629	807	Guanajuato
2020-08-03	619	457	1,076	170	629	799	Guanajuato
2020-08-04	629	506	1,135	181	615	796	Guanajuato
2020-08-05	582	550	1,132	171	597	768	Guanajuato
2020-08-06	593	576	1,169	171	644	815	Guanajuato
2020-08-07	563	612	1,175	182	627	809	Guanajuato
2020-08-08	526	586	1,112	185	634	819	Guanajuato
2020-08-09	533	583	1,116	158	640	798	Guanajuato
2020-08-10	540	619	1,159	146	623	769	Guanajuato
2020-08-11	528	647	1,175	155	633	788	Guanajuato
2020-08-12	523	663	1,186	155	652	807	Guanajuato
2020-08-13	499	685	1,184	150	654	804	Guanajuato
2020-08-14	486	700	1,186	160	644	804	Guanajuato
2020-08-15	455	712	1,167	159	648	807	Guanajuato
2020-08-16	445	715	1,160	160	651	811	Guanajuato
2020-08-17	463	716	1,179	145	664	809	Guanajuato
2020-08-18	461	746	1,207	138	650	788	Guanajuato
2020-08-19	432	761	1,193	138	668	806	Guanajuato
2020-08-20	437	755	1,192	139	671	810	Guanajuato
2020-08-21	418	768	1,186	137	661	798	Guanajuato
2020-08-22	385	776	1,161	141	668	809	Guanajuato
2020-08-23	389	758	1,147	132	657	789	Guanajuato
2020-08-24	401	794	1,195	123	673	796	Guanajuato
2020-08-25	406	793	1,199	116	669	785	Guanajuato
2020-08-26	378	770	1,148	113	685	798	Guanajuato
2020-08-27	369	816	1,185	121	684	805	Guanajuato
2020-08-28	378	815	1,193	125	669	794	Guanajuato
2020-08-29	382	828	1,210	120	659	779	Guanajuato
2020-08-30	362	789	1,151	123	659	782	Guanajuato
2020-08-31	374	824	1,198	105	692	797	Guanajuato
2020-09-01	367	820	1,187	110	683	793	Guanajuato
2020-09-02	349	851	1,200	109	687	796	Guanajuato
2020-09-03	345	850	1,195	112	683	795	Guanajuato
2020-09-04	325	842	1,167	121	658	779	Guanajuato
2020-09-05	333	861	1,194	122	684	806	Guanajuato
2020-09-06	333	849	1,182	116	654	770	Guanajuato
2020-04-07	4	58	62	2	15	17	Guerrero
2020-04-08	4	58	62	2	15	17	Guerrero
2020-04-09	2	16	18	4	15	19	Guerrero
2020-04-10	36	92	128	4	60	64	Guerrero
2020-04-11	13	71	84	4	46	50	Guerrero
2020-04-12	19	107	126	7	51	58	Guerrero
2020-04-13	23	96	119	7	63	70	Guerrero
2020-04-14	20	95	115	6	64	70	Guerrero
2020-04-15	19	32	51	3	44	47	Guerrero
2020-04-16	19	109	128	9	68	77	Guerrero
2020-04-17	23	85	108	8	62	70	Guerrero
2020-04-18	22	93	115	10	68	78	Guerrero
2020-04-19	18	62	80	10	42	52	Guerrero
2020-04-20	32	104	136	12	74	86	Guerrero
2020-04-21	35	144	179	16	120	136	Guerrero
2020-04-22	27	134	161	17	109	126	Guerrero
2020-04-23	28	136	164	13	112	125	Guerrero
2020-04-24	30	123	153	12	112	124	Guerrero
2020-04-25	25	131	156	17	127	144	Guerrero
2020-04-26	18	115	133	16	109	125	Guerrero
2020-04-27	41	126	167	15	111	126	Guerrero
2020-04-28	40	85	125	13	61	74	Guerrero
2020-04-29	58	119	177	10	79	89	Guerrero
2020-04-30	65	132	197	15	58	73	Guerrero
2020-05-01	65	124	189	13	69	82	Guerrero
2020-05-02	52	112	164	9	57	66	Guerrero
2020-05-03	79	153	232	18	69	87	Guerrero
2020-05-04	80	136	216	19	60	79	Guerrero
2020-05-05	87	131	218	21	59	80	Guerrero
2020-05-06	62	107	169	17	68	85	Guerrero
2020-05-07	83	130	213	16	69	85	Guerrero
2020-05-08	87	135	222	21	64	85	Guerrero
2020-05-09	74	115	189	20	60	80	Guerrero
2020-05-10	101	121	222	21	69	90	Guerrero
2020-05-11	136	131	267	23	62	85	Guerrero
2020-05-12	123	131	254	30	66	96	Guerrero
2020-05-13	131	120	251	32	61	93	Guerrero
2020-05-14	131	107	238	31	63	94	Guerrero
2020-05-15	124	105	229	36	62	98	Guerrero
2020-05-16	90	106	196	35	42	77	Guerrero
2020-05-17	103	101	204	40	43	83	Guerrero
2020-05-18	135	95	230	41	49	90	Guerrero
2020-05-19	139	96	235	43	60	103	Guerrero
2020-05-20	134	78	212	46	66	112	Guerrero
2020-05-21	138	56	194	52	68	120	Guerrero
2020-05-22	205	64	269	50	57	107	Guerrero
2020-05-23	236	62	298	50	60	110	Guerrero
2020-05-24	230	65	295	53	47	100	Guerrero
2020-05-25	227	67	294	53	42	95	Guerrero
2020-05-26	221	71	292	55	45	100	Guerrero
2020-05-27	224	110	334	71	75	146	Guerrero
2020-05-28	220	135	355	68	55	123	Guerrero
2020-05-29	212	149	361	63	64	127	Guerrero
2020-05-30	251	128	379	62	62	124	Guerrero
2020-05-31	255	118	373	61	79	140	Guerrero
2020-06-01	279	106	385	62	78	140	Guerrero
2020-06-02	281	153	434	64	87	151	Guerrero
2020-06-03	274	149	423	65	88	153	Guerrero
2020-06-04	260	169	429	67	97	164	Guerrero
2020-06-05	256	171	427	73	78	151	Guerrero
2020-06-06	278	155	433	78	79	157	Guerrero
2020-06-07	253	204	457	87	86	173	Guerrero
2020-06-08	259	220	479	85	93	178	Guerrero
2020-06-09	276	193	469	89	87	176	Guerrero
2020-06-10	284	193	477	82	86	168	Guerrero
2020-06-11	272	201	473	77	88	165	Guerrero
2020-06-12	284	203	487	90	90	180	Guerrero
2020-06-13	267	215	482	80	82	162	Guerrero
2020-06-14	277	208	485	95	87	182	Guerrero
2020-06-15	300	200	500	80	81	161	Guerrero
2020-06-16	281	171	452	80	70	150	Guerrero
2020-06-17	303	196	499	98	88	186	Guerrero
2020-06-18	282	210	492	94	91	185	Guerrero
2020-06-19	275	212	487	94	95	189	Guerrero
2020-06-20	272	208	480	88	97	185	Guerrero
2020-06-21	248	236	484	93	97	190	Guerrero
2020-06-22	250	237	487	91	97	188	Guerrero
2020-06-23	261	235	496	82	117	199	Guerrero
2020-06-24	264	246	510	85	124	209	Guerrero
2020-06-25	257	261	518	91	107	198	Guerrero
2020-06-26	250	309	559	99	103	202	Guerrero
2020-06-27	245	311	556	102	111	213	Guerrero
2020-06-28	242	306	548	96	115	211	Guerrero
2020-06-29	239	318	557	92	113	205	Guerrero
2020-06-30	243	317	560	86	111	197	Guerrero
2020-07-01	224	332	556	90	112	202	Guerrero
2020-07-02	215	330	545	89	109	198	Guerrero
2020-07-03	221	326	547	88	106	194	Guerrero
2020-07-04	206	313	519	90	91	181	Guerrero
2020-07-05	232	324	556	78	117	195	Guerrero
2020-07-06	223	343	566	84	110	194	Guerrero
2020-07-07	190	347	537	80	117	197	Guerrero
2020-07-08	210	359	569	79	122	201	Guerrero
2020-07-09	211	359	570	78	122	200	Guerrero
2020-07-10	216	376	592	87	121	208	Guerrero
2020-07-11	213	387	600	93	119	212	Guerrero
2020-07-12	213	386	599	93	105	198	Guerrero
2020-07-13	222	409	631	89	132	221	Guerrero
2020-07-14	239	405	644	86	126	212	Guerrero
2020-07-15	226	375	601	85	133	218	Guerrero
2020-07-16	222	375	597	78	129	207	Guerrero
2020-07-17	217	362	579	82	120	202	Guerrero
2020-07-18	225	377	602	75	125	200	Guerrero
2020-07-19	234	408	642	80	128	208	Guerrero
2020-07-20	218	412	630	73	148	221	Guerrero
2020-07-21	226	413	639	70	156	226	Guerrero
2020-07-22	216	416	632	72	148	220	Guerrero
2020-07-23	218	413	631	73	159	232	Guerrero
2020-07-24	209	406	615	73	167	240	Guerrero
2020-07-25	214	421	635	67	159	226	Guerrero
2020-07-26	227	411	638	58	170	228	Guerrero
2020-07-27	230	353	583	53	174	227	Guerrero
2020-07-28	208	376	584	60	164	224	Guerrero
2020-07-29	202	421	623	63	173	236	Guerrero
2020-07-30	202	421	623	60	168	228	Guerrero
2020-07-31	197	432	629	57	170	227	Guerrero
2020-08-01	183	425	608	50	168	218	Guerrero
2020-08-02	194	388	582	51	167	218	Guerrero
2020-08-03	208	416	624	47	181	228	Guerrero
2020-08-04	215	406	621	46	183	229	Guerrero
2020-08-05	214	404	618	48	181	229	Guerrero
2020-08-06	208	411	619	45	181	226	Guerrero
2020-08-07	209	413	622	46	179	225	Guerrero
2020-08-08	203	433	636	45	188	233	Guerrero
2020-08-09	200	376	576	47	191	238	Guerrero
2020-08-10	201	417	618	53	178	231	Guerrero
2020-08-11	196	432	628	49	174	223	Guerrero
2020-08-12	192	418	610	41	174	215	Guerrero
2020-08-13	201	425	626	44	179	223	Guerrero
2020-08-14	191	391	582	40	177	217	Guerrero
2020-08-15	184	426	610	50	185	235	Guerrero
2020-08-16	196	417	613	46	185	231	Guerrero
2020-08-17	188	413	601	53	178	231	Guerrero
2020-08-18	183	413	596	46	196	242	Guerrero
2020-08-19	179	418	597	41	200	241	Guerrero
2020-08-20	166	425	591	39	201	240	Guerrero
2020-08-21	179	423	602	31	198	229	Guerrero
2020-08-22	168	433	601	33	203	236	Guerrero
2020-08-23	164	411	575	29	198	227	Guerrero
2020-08-24	171	422	593	35	198	233	Guerrero
2020-08-25	164	396	560	36	236	272	Guerrero
2020-08-26	155	420	575	28	206	234	Guerrero
2020-08-27	156	450	606	30	201	231	Guerrero
2020-08-28	143	416	559	30	173	203	Guerrero
2020-08-29	149	441	590	30	206	236	Guerrero
2020-08-30	150	442	592	28	205	233	Guerrero
2020-08-31	155	342	497	29	189	218	Guerrero
2020-09-01	152	366	518	31	206	237	Guerrero
2020-09-02	155	372	527	31	222	253	Guerrero
2020-09-03	154	345	499	29	212	241	Guerrero
2020-09-04	157	369	526	27	225	252	Guerrero
2020-09-05	150	383	533	29	225	254	Guerrero
2020-09-06	139	343	482	34	208	242	Guerrero
2020-04-07	5	36	41	2	33	35	Hidalgo
2020-04-08	5	36	41	2	21	23	Hidalgo
2020-04-09	4	40	44	2	27	29	Hidalgo
2020-04-10	6	41	47	2	24	26	Hidalgo
2020-04-11	8	45	53	2	24	26	Hidalgo
2020-04-12	9	44	53	3	23	26	Hidalgo
2020-04-13	10	43	53	3	23	26	Hidalgo
2020-04-14	10	43	53	3	24	27	Hidalgo
2020-04-15	12	69	81	2	25	27	Hidalgo
2020-04-16	15	70	85	2	31	33	Hidalgo
2020-04-17	16	70	86	2	29	31	Hidalgo
2020-04-18	20	68	88	2	58	60	Hidalgo
2020-04-19	20	68	88	2	59	61	Hidalgo
2020-04-20	25	112	137	3	66	69	Hidalgo
2020-04-21	44	172	216	10	132	142	Hidalgo
2020-04-22	44	189	233	12	134	146	Hidalgo
2020-04-23	43	201	244	13	134	147	Hidalgo
2020-04-24	50	204	254	21	162	183	Hidalgo
2020-04-25	45	189	234	15	151	166	Hidalgo
2020-04-26	46	221	267	19	140	159	Hidalgo
2020-04-27	38	191	229	15	154	169	Hidalgo
2020-04-28	54	166	220	19	115	134	Hidalgo
2020-04-29	60	168	228	17	103	120	Hidalgo
2020-04-30	58	262	320	28	103	131	Hidalgo
2020-05-01	53	268	321	28	107	135	Hidalgo
2020-05-02	58	179	237	27	112	139	Hidalgo
2020-05-03	79	170	249	24	111	135	Hidalgo
2020-05-04	111	166	277	34	103	137	Hidalgo
2020-05-05	105	190	295	35	107	142	Hidalgo
2020-05-06	94	173	267	36	106	142	Hidalgo
2020-05-07	88	187	275	41	97	138	Hidalgo
2020-05-08	107	180	287	38	96	134	Hidalgo
2020-05-09	109	180	289	39	99	138	Hidalgo
2020-05-10	120	179	299	35	97	132	Hidalgo
2020-05-11	131	271	402	38	132	170	Hidalgo
2020-05-12	140	244	384	34	122	156	Hidalgo
2020-05-13	140	246	386	39	120	159	Hidalgo
2020-05-14	135	249	384	37	126	163	Hidalgo
2020-05-15	143	220	363	35	123	158	Hidalgo
2020-05-16	157	206	363	32	111	143	Hidalgo
2020-05-17	161	224	385	31	112	143	Hidalgo
2020-05-18	155	228	383	25	111	136	Hidalgo
2020-05-19	173	234	407	32	112	144	Hidalgo
2020-05-20	176	231	407	29	113	142	Hidalgo
2020-05-21	187	236	423	36	109	145	Hidalgo
2020-05-22	151	160	311	26	101	127	Hidalgo
2020-05-23	192	181	373	29	103	132	Hidalgo
2020-05-24	184	198	382	30	103	133	Hidalgo
2020-05-25	189	172	361	32	92	124	Hidalgo
2020-05-26	198	228	426	33	115	148	Hidalgo
2020-05-27	165	231	396	37	97	134	Hidalgo
2020-05-28	170	218	388	34	113	147	Hidalgo
2020-05-29	183	204	387	33	129	162	Hidalgo
2020-05-30	177	216	393	32	132	164	Hidalgo
2020-05-31	173	219	392	34	130	164	Hidalgo
2020-06-01	189	244	433	37	152	189	Hidalgo
2020-06-02	188	204	392	41	138	179	Hidalgo
2020-06-03	161	208	369	40	132	172	Hidalgo
2020-06-04	186	280	466	45	160	205	Hidalgo
2020-06-05	191	346	537	44	195	239	Hidalgo
2020-06-06	202	273	475	47	155	202	Hidalgo
2020-06-07	206	266	472	52	149	201	Hidalgo
2020-06-08	216	250	466	53	146	199	Hidalgo
2020-06-09	210	260	470	54	144	198	Hidalgo
2020-06-10	214	292	506	48	166	214	Hidalgo
2020-06-11	206	299	505	44	177	221	Hidalgo
2020-06-12	212	300	512	45	164	209	Hidalgo
2020-06-13	179	269	448	30	160	190	Hidalgo
2020-06-14	230	277	507	43	176	219	Hidalgo
2020-06-15	235	286	521	46	166	212	Hidalgo
2020-06-16	241	286	527	51	162	213	Hidalgo
2020-06-17	232	287	519	53	166	219	Hidalgo
2020-06-18	226	327	553	48	172	220	Hidalgo
2020-06-19	213	341	554	46	169	215	Hidalgo
2020-06-20	217	331	548	49	169	218	Hidalgo
2020-06-21	429	374	803	47	180	227	Hidalgo
2020-06-22	231	362	593	48	173	221	Hidalgo
2020-06-23	232	370	602	49	171	220	Hidalgo
2020-06-24	234	365	599	51	167	218	Hidalgo
2020-06-25	232	367	599	46	173	219	Hidalgo
2020-06-26	222	375	597	46	177	223	Hidalgo
2020-06-27	222	359	581	40	186	226	Hidalgo
2020-06-28	228	356	584	42	183	225	Hidalgo
2020-06-29	234	353	587	46	175	221	Hidalgo
2020-06-30	233	362	595	40	204	244	Hidalgo
2020-07-01	219	404	623	39	193	232	Hidalgo
2020-07-02	220	412	632	43	189	232	Hidalgo
2020-07-03	218	413	631	42	194	236	Hidalgo
2020-07-04	204	384	588	41	172	213	Hidalgo
2020-07-05	215	419	634	45	189	234	Hidalgo
2020-07-06	233	413	646	46	189	235	Hidalgo
2020-07-07	241	392	633	43	197	240	Hidalgo
2020-07-08	239	388	627	46	195	241	Hidalgo
2020-07-09	237	417	654	45	195	240	Hidalgo
2020-07-10	234	398	632	47	197	244	Hidalgo
2020-07-11	235	396	631	54	185	239	Hidalgo
2020-07-12	226	371	597	57	167	224	Hidalgo
2020-07-13	325	383	708	52	189	241	Hidalgo
2020-07-14	255	377	632	47	192	239	Hidalgo
2020-07-15	260	390	650	50	180	230	Hidalgo
2020-07-16	252	387	639	55	177	232	Hidalgo
2020-07-17	265	394	659	57	184	241	Hidalgo
2020-07-18	260	385	645	50	180	230	Hidalgo
2020-07-19	263	403	666	56	178	234	Hidalgo
2020-07-20	283	489	772	58	201	259	Hidalgo
2020-07-21	284	455	739	50	200	250	Hidalgo
2020-07-22	268	368	636	55	172	227	Hidalgo
2020-07-23	285	465	750	57	183	240	Hidalgo
2020-07-24	327	545	872	74	206	280	Hidalgo
2020-07-25	179	158	337	21	124	145	Hidalgo
2020-07-26	299	448	747	56	188	244	Hidalgo
2020-07-27	313	457	770	57	205	262	Hidalgo
2020-07-28	303	468	771	61	197	258	Hidalgo
2020-07-29	298	429	727	63	192	255	Hidalgo
2020-07-30	283	445	728	65	189	254	Hidalgo
2020-07-31	259	430	689	66	182	248	Hidalgo
2020-08-01	281	444	725	69	190	259	Hidalgo
2020-08-02	295	442	737	77	185	262	Hidalgo
2020-08-03	292	440	732	74	188	262	Hidalgo
2020-08-04	292	438	730	73	187	260	Hidalgo
2020-08-05	292	434	726	75	188	263	Hidalgo
2020-08-06	299	431	730	70	324	394	Hidalgo
2020-08-07	300	433	733	67	199	266	Hidalgo
2020-08-08	299	443	742	70	195	265	Hidalgo
2020-08-09	312	414	726	69	187	256	Hidalgo
2020-08-10	316	411	727	67	190	257	Hidalgo
2020-08-11	313	412	725	67	191	258	Hidalgo
2020-08-12	306	414	720	64	193	257	Hidalgo
2020-08-13	321	407	728	59	195	254	Hidalgo
2020-08-14	326	418	744	57	191	248	Hidalgo
2020-08-15	321	415	736	61	191	252	Hidalgo
2020-08-16	319	411	730	61	187	248	Hidalgo
2020-08-17	334	395	729	58	190	248	Hidalgo
2020-08-18	325	287	612	56	155	211	Hidalgo
2020-08-19	321	394	715	60	184	244	Hidalgo
2020-08-20	299	392	691	62	186	248	Hidalgo
2020-08-21	323	274	597	57	168	225	Hidalgo
2020-08-22	331	272	603	50	173	223	Hidalgo
2020-08-23	327	280	607	53	161	214	Hidalgo
2020-08-24	330	276	606	58	158	216	Hidalgo
2020-08-25	336	272	608	50	169	219	Hidalgo
2020-08-26	350	394	744	51	200	251	Hidalgo
2020-08-27	339	265	604	57	165	222	Hidalgo
2020-08-28	313	284	597	62	162	224	Hidalgo
2020-08-29	300	299	599	60	163	223	Hidalgo
2020-08-30	311	280	591	59	166	225	Hidalgo
2020-08-31	305	257	562	61	167	228	Hidalgo
2020-09-01	304	286	590	60	164	224	Hidalgo
2020-09-02	288	288	576	60	148	208	Hidalgo
2020-09-03	290	300	590	57	165	222	Hidalgo
2020-09-04	294	297	591	55	164	219	Hidalgo
2020-09-05	281	341	622	56	181	237	Hidalgo
2020-09-06	262	345	607	55	174	229	Hidalgo
2020-04-07	28	470	498	4	179	183	Jalisco
2020-04-08	29	469	498	4	178	182	Jalisco
2020-04-09	25	477	502	7	177	184	Jalisco
2020-04-10	22	472	494	6	178	184	Jalisco
2020-04-11	17	506	523	11	217	228	Jalisco
2020-04-12	17	505	522	12	214	226	Jalisco
2020-04-13	23	503	526	7	293	300	Jalisco
2020-04-14	37	503	540	6	289	295	Jalisco
2020-04-15	35	505	540	6	287	293	Jalisco
2020-04-16	36	505	541	8	283	291	Jalisco
2020-04-17	34	506	540	6	272	278	Jalisco
2020-04-18	34	520	554	7	281	288	Jalisco
2020-04-19	35	520	555	6	271	277	Jalisco
2020-04-20	63	677	740	11	416	427	Jalisco
2020-04-21	63	727	790	13	495	508	Jalisco
2020-04-22	60	922	982	13	364	377	Jalisco
2020-04-23	55	979	1,034	17	362	379	Jalisco
2020-04-24	47	1011	1,058	17	364	381	Jalisco
2020-04-25	48	1036	1,084	15	363	378	Jalisco
2020-04-26	56	1170	1,226	18	430	448	Jalisco
2020-04-27	65	1290	1,355	20	448	468	Jalisco
2020-04-28	70	1349	1,419	15	347	362	Jalisco
2020-04-29	70	1378	1,448	12	366	378	Jalisco
2020-04-30	76	1381	1,457	12	364	376	Jalisco
2020-05-01	77	1368	1,445	11	358	369	Jalisco
2020-05-02	84	1367	1,451	11	357	368	Jalisco
2020-05-03	80	1367	1,447	11	345	356	Jalisco
2020-05-04	107	1340	1,447	12	323	335	Jalisco
2020-05-05	99	1362	1,461	21	321	342	Jalisco
2020-05-06	106	1380	1,486	19	333	352	Jalisco
2020-05-07	114	1706	1,820	24	518	542	Jalisco
2020-05-08	124	1738	1,862	33	503	536	Jalisco
2020-05-09	126	1749	1,875	26	494	520	Jalisco
2020-05-10	123	1733	1,856	27	492	519	Jalisco
2020-05-11	147	1736	1,883	29	540	569	Jalisco
2020-05-12	140	1737	1,877	33	534	567	Jalisco
2020-05-13	145	1729	1,874	25	533	558	Jalisco
2020-05-14	160	1715	1,875	36	526	562	Jalisco
2020-05-15	179	1444	1,623	33	525	558	Jalisco
2020-05-16	167	1460	1,627	32	535	567	Jalisco
2020-05-17	158	1464	1,622	26	540	566	Jalisco
2020-05-18	163	1479	1,642	25	545	570	Jalisco
2020-05-19	169	1465	1,634	24	538	562	Jalisco
2020-05-20	165	1473	1,638	22	568	590	Jalisco
2020-05-21	171	1475	1,646	31	566	597	Jalisco
2020-05-22	169	1486	1,655	45	554	599	Jalisco
2020-05-23	179	1484	1,663	39	539	578	Jalisco
2020-05-24	184	1482	1,666	42	545	587	Jalisco
2020-05-25	216	1496	1,712	41	549	590	Jalisco
2020-05-26	210	1502	1,712	46	535	581	Jalisco
2020-05-27	232	1468	1,700	57	534	591	Jalisco
2020-05-28	232	1464	1,696	67	529	596	Jalisco
2020-05-29	267	1476	1,743	69	533	602	Jalisco
2020-05-30	260	1503	1,763	72	500	572	Jalisco
2020-05-31	290	1495	1,785	74	503	577	Jalisco
2020-06-01	324	1345	1,669	77	509	586	Jalisco
2020-06-02	367	1256	1,623	85	462	547	Jalisco
2020-06-03	377	1192	1,569	89	459	548	Jalisco
2020-06-04	393	1173	1,566	91	455	546	Jalisco
2020-06-05	410	1183	1,593	98	454	552	Jalisco
2020-06-06	404	1130	1,534	99	474	573	Jalisco
2020-06-07	432	1150	1,582	103	485	588	Jalisco
2020-06-08	460	1139	1,599	112	479	591	Jalisco
2020-06-09	518	1130	1,648	116	477	593	Jalisco
2020-06-10	550	1211	1,761	126	483	609	Jalisco
2020-06-11	559	1225	1,784	130	471	601	Jalisco
2020-06-12	612	1206	1,818	134	478	612	Jalisco
2020-06-13	538	1201	1,739	130	475	605	Jalisco
2020-06-14	530	1211	1,741	149	481	630	Jalisco
2020-06-15	571	1222	1,793	152	463	615	Jalisco
2020-06-16	614	1205	1,819	160	476	636	Jalisco
2020-06-17	574	1190	1,764	172	472	644	Jalisco
2020-06-18	643	1497	2,140	169	488	657	Jalisco
2020-06-19	612	1739	2,351	182	497	679	Jalisco
2020-06-20	593	1805	2,398	185	471	656	Jalisco
2020-06-21	623	1836	2,459	187	472	659	Jalisco
2020-06-22	642	1785	2,427	165	481	646	Jalisco
2020-06-23	591	1824	2,415	163	482	645	Jalisco
2020-06-24	612	1797	2,409	183	474	657	Jalisco
2020-06-25	610	1933	2,543	172	465	637	Jalisco
2020-06-26	603	1983	2,586	187	457	644	Jalisco
2020-06-27	602	1992	2,594	193	473	666	Jalisco
2020-06-28	594	1938	2,532	203	466	669	Jalisco
2020-06-29	613	1964	2,577	206	459	665	Jalisco
2020-06-30	608	1989	2,597	204	460	664	Jalisco
2020-07-01	626	1857	2,483	195	449	644	Jalisco
2020-07-02	600	1971	2,571	192	475	667	Jalisco
2020-07-03	643	2020	2,663	209	477	686	Jalisco
2020-07-04	635	2023	2,658	203	489	692	Jalisco
2020-07-05	621	1998	2,619	199	484	683	Jalisco
2020-07-06	637	2109	2,746	194	499	693	Jalisco
2020-07-07	594	1882	2,476	189	415	604	Jalisco
2020-07-08	636	2121	2,757	199	487	686	Jalisco
2020-07-09	669	2084	2,753	184	496	680	Jalisco
2020-07-10	698	2096	2,794	180	510	690	Jalisco
2020-07-11	685	2082	2,767	185	530	715	Jalisco
2020-07-12	701	2053	2,754	186	500	686	Jalisco
2020-07-13	679	2070	2,749	192	506	698	Jalisco
2020-07-14	653	2067	2,720	199	503	702	Jalisco
2020-07-15	644	2073	2,717	204	505	709	Jalisco
2020-07-16	629	2119	2,748	201	526	727	Jalisco
2020-07-17	641	2154	2,795	198	518	716	Jalisco
2020-07-18	631	2148	2,779	194	530	724	Jalisco
2020-07-19	662	2140	2,802	194	519	713	Jalisco
2020-07-20	639	2107	2,746	183	528	711	Jalisco
2020-07-21	697	2123	2,820	178	540	718	Jalisco
2020-07-22	713	2083	2,796	176	521	697	Jalisco
2020-07-23	694	2079	2,773	185	528	713	Jalisco
2020-07-24	690	2085	2,775	185	531	716	Jalisco
2020-07-25	728	2128	2,856	188	512	700	Jalisco
2020-07-26	740	2060	2,800	192	513	705	Jalisco
2020-07-27	769	2026	2,795	204	497	701	Jalisco
2020-07-28	739	1992	2,731	206	464	670	Jalisco
2020-07-29	761	2005	2,766	208	493	701	Jalisco
2020-07-30	711	2054	2,765	209	497	706	Jalisco
2020-07-31	691	2089	2,780	215	499	714	Jalisco
2020-08-01	695	2099	2,794	222	488	710	Jalisco
2020-08-02	709	2088	2,797	199	523	722	Jalisco
2020-08-03	703	2088	2,791	218	511	729	Jalisco
2020-08-04	689	2049	2,738	220	503	723	Jalisco
2020-08-05	691	2075	2,766	241	492	733	Jalisco
2020-08-06	648	2132	2,780	229	507	736	Jalisco
2020-08-07	635	1879	2,514	233	737	970	Jalisco
2020-08-08	671	2077	2,748	219	494	713	Jalisco
2020-08-09	674	2118	2,792	219	490	709	Jalisco
2020-08-10	670	2101	2,771	218	505	723	Jalisco
2020-08-11	703	2132	2,835	216	522	738	Jalisco
2020-08-12	675	2125	2,800	203	494	697	Jalisco
2020-08-13	678	2112	2,790	211	515	726	Jalisco
2020-08-14	667	2096	2,763	213	515	728	Jalisco
2020-08-15	693	2047	2,740	208	514	722	Jalisco
2020-08-16	682	2020	2,702	209	508	717	Jalisco
2020-08-17	692	2102	2,794	216	533	749	Jalisco
2020-08-18	669	2063	2,732	224	448	672	Jalisco
2020-08-19	716	1989	2,705	219	455	674	Jalisco
2020-08-20	652	1988	2,640	238	457	695	Jalisco
2020-08-21	659	2057	2,716	226	452	678	Jalisco
2020-08-22	692	2037	2,729	218	452	670	Jalisco
2020-08-23	694	2060	2,754	210	420	630	Jalisco
2020-08-24	717	1971	2,688	212	411	623	Jalisco
2020-08-25	695	1970	2,665	202	469	671	Jalisco
2020-08-26	671	2041	2,712	203	435	638	Jalisco
2020-08-27	657	2062	2,719	206	451	657	Jalisco
2020-08-28	657	2110	2,767	207	470	677	Jalisco
2020-08-29	633	2112	2,745	212	480	692	Jalisco
2020-08-30	644	2094	2,738	219	456	675	Jalisco
2020-08-31	638	2063	2,701	219	454	673	Jalisco
2020-09-01	639	2092	2,731	212	454	666	Jalisco
2020-09-02	644	2074	2,718	201	460	661	Jalisco
2020-09-03	631	2112	2,743	200	464	664	Jalisco
2020-09-04	622	2109	2,731	194	461	655	Jalisco
2020-09-05	650	2102	2,752	182	475	657	Jalisco
2020-09-06	607	2085	2,692	182	496	678	Jalisco
2020-04-01	5	0	5	2	10	12	Estado de México
2020-04-02	8	0	8	2	10	12	Estado de México
2020-04-03	7	20	27	4	19	23	Estado de México
2020-04-04	9	20	29	1	19	20	Estado de México
2020-04-05	7	20	27	3	19	22	Estado de México
2020-04-06	92	411	503	23	303	326	Estado de México
2020-04-07	84	403	487	22	299	321	Estado de México
2020-04-08	318	706	1,024	94	440	534	Estado de México
2020-04-09	367	748	1,115	85	405	490	Estado de México
2020-04-10	391	775	1,166	102	429	531	Estado de México
2020-04-11	396	873	1,269	99	531	630	Estado de México
2020-04-12	399	870	1,269	104	481	585	Estado de México
2020-04-13	288	751	1,039	93	411	504	Estado de México
2020-04-14	174	393	567	36	193	229	Estado de México
2020-04-15	448	839	1,287	81	401	482	Estado de México
2020-04-16	511	872	1,383	84	401	485	Estado de México
2020-04-17	528	780	1,308	91	409	500	Estado de México
2020-04-18	498	885	1,383	133	399	532	Estado de México
2020-04-19	602	928	1,530	149	405	554	Estado de México
2020-04-20	602	1052	1,654	142	522	664	Estado de México
2020-04-21	590	1194	1,784	120	642	762	Estado de México
2020-04-22	708	1205	1,913	134	638	772	Estado de México
2020-04-23	773	1278	2,051	145	616	761	Estado de México
2020-04-24	791	1281	2,072	138	594	732	Estado de México
2020-04-25	849	1301	2,150	161	606	767	Estado de México
2020-04-26	914	1359	2,273	193	631	824	Estado de México
2020-04-27	981	1415	2,396	229	346	575	Estado de México
2020-04-28	1263	1586	2,849	242	359	601	Estado de México
2020-04-29	1338	1559	2,897	269	321	590	Estado de México
2020-04-30	1439	1585	3,024	266	350	616	Estado de México
2020-05-01	1528	1566	3,094	267	340	607	Estado de México
2020-05-02	1587	1469	3,056	269	345	614	Estado de México
2020-05-03	1616	1462	3,078	256	334	590	Estado de México
2020-05-04	1613	1366	2,979	239	316	555	Estado de México
2020-05-05	1554	1249	2,803	280	301	581	Estado de México
2020-05-06	1555	1254	2,809	251	302	553	Estado de México
2020-05-07	1513	1274	2,787	306	281	587	Estado de México
2020-05-08	1611	1193	2,804	281	284	565	Estado de México
2020-05-09	1612	1209	2,821	276	287	563	Estado de México
2020-05-10	1648	1245	2,893	285	304	589	Estado de México
2020-05-11	1734	1313	3,047	351	313	664	Estado de México
2020-05-12	1698	1257	2,955	334	286	620	Estado de México
2020-05-13	1805	1385	3,190	366	303	669	Estado de México
2020-05-14	1786	1313	3,099	389	281	670	Estado de México
2020-05-15	1854	1310	3,164	376	257	633	Estado de México
2020-05-16	1910	1304	3,214	339	282	621	Estado de México
2020-05-17	2030	1287	3,317	350	294	644	Estado de México
2020-05-18	1977	1328	3,305	373	297	670	Estado de México
2020-05-19	1968	1308	3,276	360	299	659	Estado de México
2020-05-20	1832	1285	3,117	455	260	715	Estado de México
2020-05-21	1861	1330	3,191	441	273	714	Estado de México
2020-05-22	1859	1339	3,198	459	261	720	Estado de México
2020-05-23	1817	1346	3,163	414	269	683	Estado de México
2020-05-24	1926	1496	3,422	463	282	745	Estado de México
2020-05-25	1945	1477	3,422	456	285	741	Estado de México
2020-05-26	1968	1193	3,161	440	273	713	Estado de México
2020-05-27	1914	1131	3,045	435	280	715	Estado de México
2020-05-28	1890	1146	3,036	436	284	720	Estado de México
2020-05-29	1907	734	2,641	455	263	718	Estado de México
2020-05-30	1940	628	2,568	463	268	731	Estado de México
2020-05-31	1938	665	2,603	430	279	709	Estado de México
2020-06-01	1995	697	2,692	461	244	705	Estado de México
2020-06-02	1993	647	2,640	465	243	708	Estado de México
2020-06-03	1916	689	2,605	453	233	686	Estado de México
2020-06-04	1968	680	2,648	465	230	695	Estado de México
2020-06-05	2012	526	2,538	453	224	677	Estado de México
2020-06-06	2004	592	2,596	478	220	698	Estado de México
2020-06-07	1945	596	2,541	418	232	650	Estado de México
2020-06-08	1971	540	2,511	420	264	684	Estado de México
2020-06-09	2000	579	2,579	451	246	697	Estado de México
2020-06-10	1947	604	2,551	450	265	715	Estado de México
2020-06-11	1921	645	2,566	442	268	710	Estado de México
2020-06-12	1848	633	2,481	460	249	709	Estado de México
2020-06-13	1865	713	2,578	448	244	692	Estado de México
2020-06-14	1830	687	2,517	442	258	700	Estado de México
2020-06-15	1748	775	2,523	462	252	714	Estado de México
2020-06-16	1837	782	2,619	472	282	754	Estado de México
2020-06-17	1778	823	2,601	473	270	743	Estado de México
2020-06-18	1804	770	2,574	461	265	726	Estado de México
2020-06-19	1662	793	2,455	390	248	638	Estado de México
2020-06-20	1710	775	2,485	440	233	673	Estado de México
2020-06-21	1758	838	2,596	469	282	751	Estado de México
2020-06-22	1689	837	2,526	461	310	771	Estado de México
2020-06-23	1680	916	2,596	449	306	755	Estado de México
2020-06-24	1655	922	2,577	462	304	766	Estado de México
2020-06-25	1607	916	2,523	486	294	780	Estado de México
2020-06-26	1462	920	2,382	400	265	665	Estado de México
2020-06-27	1528	916	2,444	432	281	713	Estado de México
2020-06-28	1590	924	2,514	462	304	766	Estado de México
2020-06-29	1598	1530	3,128	452	394	846	Estado de México
2020-06-30	1539	1081	2,620	451	350	801	Estado de México
2020-07-01	1505	1111	2,616	428	359	787	Estado de México
2020-07-02	1534	1243	2,777	433	368	801	Estado de México
2020-07-03	1442	1100	2,542	392	347	739	Estado de México
2020-07-04	1505	1115	2,620	428	368	796	Estado de México
2020-07-05	1506	1155	2,661	419	388	807	Estado de México
2020-07-06	1502	1164	2,666	414	391	805	Estado de México
2020-07-07	1455	1176	2,631	420	398	818	Estado de México
2020-07-08	1435	1237	2,672	417	379	796	Estado de México
2020-07-09	1424	1350	2,774	419	368	787	Estado de México
2020-07-10	1383	1384	2,767	425	351	776	Estado de México
2020-07-11	1398	1391	2,789	427	352	779	Estado de México
2020-07-12	1404	1356	2,760	438	343	781	Estado de México
2020-07-13	1425	1471	2,896	426	360	786	Estado de México
2020-07-14	1384	1442	2,826	427	588	1,015	Estado de México
2020-07-15	1369	1422	2,791	417	600	1,017	Estado de México
2020-07-16	1322	1423	2,745	428	596	1,024	Estado de México
2020-07-17	1274	1470	2,744	415	592	1,007	Estado de México
2020-07-18	1259	1507	2,766	427	580	1,007	Estado de México
2020-07-19	1278	1491	2,769	409	598	1,007	Estado de México
2020-07-20	1307	1429	2,736	393	596	989	Estado de México
2020-07-21	1374	1491	2,865	398	594	992	Estado de México
2020-07-22	1360	1473	2,833	411	579	990	Estado de México
2020-07-23	1336	1524	2,860	401	587	988	Estado de México
2020-07-24	1309	1484	2,793	422	560	982	Estado de México
2020-07-25	1308	1538	2,846	413	568	981	Estado de México
2020-07-26	1292	1563	2,855	401	577	978	Estado de México
2020-07-27	1326	1497	2,823	398	572	970	Estado de México
2020-07-28	1328	1496	2,824	401	563	964	Estado de México
2020-07-29	1300	1557	2,857	408	559	967	Estado de México
2020-07-30	1295	1553	2,848	411	539	950	Estado de México
2020-07-31	1246	1545	2,791	394	518	912	Estado de México
2020-08-01	1253	1384	2,637	369	545	914	Estado de México
2020-08-02	1267	1562	2,829	377	598	975	Estado de México
2020-08-03	1297	1587	2,884	361	609	970	Estado de México
2020-08-04	1208	1618	2,826	373	606	979	Estado de México
2020-08-05	1236	1587	2,823	350	629	979	Estado de México
2020-08-06	1222	1603	2,825	365	621	986	Estado de México
2020-08-07	1170	1650	2,820	376	613	989	Estado de México
2020-08-08	1180	1645	2,825	384	592	976	Estado de México
2020-08-09	1166	1642	2,808	373	616	989	Estado de México
2020-08-10	1177	1628	2,805	371	625	996	Estado de México
2020-08-11	1195	1618	2,813	376	617	993	Estado de México
2020-08-12	1185	1603	2,788	383	611	994	Estado de México
2020-08-13	1206	1596	2,802	370	617	987	Estado de México
2020-08-14	1143	1572	2,715	336	604	940	Estado de México
2020-08-15	1137	1606	2,743	345	598	943	Estado de México
2020-08-16	1190	1585	2,775	357	615	972	Estado de México
2020-08-17	1207	1577	2,784	356	610	966	Estado de México
2020-08-18	1211	1589	2,800	357	620	977	Estado de México
2020-08-19	1196	1560	2,756	341	632	973	Estado de México
2020-08-20	1160	1649	2,809	336	648	984	Estado de México
2020-08-21	1060	1694	2,754	302	623	925	Estado de México
2020-08-22	1073	1696	2,769	315	619	934	Estado de México
2020-08-23	1118	1645	2,763	350	640	990	Estado de México
2020-08-24	1127	1649	2,776	330	651	981	Estado de México
2020-08-25	1105	1480	2,585	314	636	950	Estado de México
2020-08-26	1045	1493	2,538	320	632	952	Estado de México
2020-08-27	1059	1725	2,784	313	667	980	Estado de México
2020-08-28	959	1530	2,489	263	636	899	Estado de México
2020-08-29	942	1601	2,543	249	641	890	Estado de México
2020-08-30	1000	1809	2,809	301	677	978	Estado de México
2020-08-31	1018	1733	2,751	306	666	972	Estado de México
2020-09-01	1083	1703	2,786	295	689	984	Estado de México
2020-09-02	1044	1781	2,825	297	683	980	Estado de México
2020-09-03	1054	1726	2,780	296	684	980	Estado de México
2020-09-04	992	1720	2,712	261	680	941	Estado de México
2020-09-05	1076	1719	2,795	282	687	969	Estado de México
2020-09-06	1814	2268	4,082	542	661	1,203	Estado de México
2020-04-07	5	35	40	3	118	121	Michoacán
2020-04-08	7	33	40	3	116	119	Michoacán
2020-04-09	42	315	357	6	163	169	Michoacán
2020-04-10	31	341	372	9	157	166	Michoacán
2020-04-11	29	349	378	9	162	171	Michoacán
2020-04-12	29	346	375	11	166	177	Michoacán
2020-04-13	30	349	379	9	164	173	Michoacán
2020-04-14	32	347	379	6	162	168	Michoacán
2020-04-15	5	111	116	3	105	108	Michoacán
2020-04-16	31	308	339	8	161	169	Michoacán
2020-04-17	35	330	365	7	171	178	Michoacán
2020-04-18	42	307	349	5	161	166	Michoacán
2020-04-19	40	345	385	5	171	176	Michoacán
2020-04-20	55	369	424	6	197	203	Michoacán
2020-04-21	46	430	476	9	211	220	Michoacán
2020-04-22	47	429	476	12	200	212	Michoacán
2020-04-23	44	448	492	13	194	207	Michoacán
2020-04-24	35	432	467	11	192	203	Michoacán
2020-04-25	32	440	472	11	187	198	Michoacán
2020-04-26	38	458	496	12	192	204	Michoacán
2020-04-27	35	461	496	11	198	209	Michoacán
2020-04-28	27	450	477	11	126	137	Michoacán
2020-04-29	48	475	523	12	131	143	Michoacán
2020-04-30	54	480	534	10	135	145	Michoacán
2020-05-01	53	460	513	10	126	136	Michoacán
2020-05-02	56	487	543	10	125	135	Michoacán
2020-05-03	63	443	506	9	116	125	Michoacán
2020-05-04	57	482	539	13	121	134	Michoacán
2020-05-05	51	485	536	15	118	133	Michoacán
2020-05-06	57	489	546	13	120	133	Michoacán
2020-05-07	54	453	507	13	123	136	Michoacán
2020-05-08	57	487	544	14	125	139	Michoacán
2020-05-09	55	486	541	17	126	143	Michoacán
2020-05-10	56	460	516	15	107	122	Michoacán
2020-05-11	71	486	557	18	123	141	Michoacán
2020-05-12	79	481	560	16	116	132	Michoacán
2020-05-13	71	483	554	13	122	135	Michoacán
2020-05-14	77	485	562	11	113	124	Michoacán
2020-05-15	56	491	547	14	119	133	Michoacán
2020-05-16	69	487	556	15	124	139	Michoacán
2020-05-17	85	485	570	18	106	124	Michoacán
2020-05-18	79	484	563	18	109	127	Michoacán
2020-05-19	67	490	557	17	110	127	Michoacán
2020-05-20	72	488	560	17	115	132	Michoacán
2020-05-21	69	485	554	17	116	133	Michoacán
2020-05-22	60	487	547	17	121	138	Michoacán
2020-05-23	61	476	537	20	110	130	Michoacán
2020-05-24	67	475	542	22	110	132	Michoacán
2020-05-25	77	481	558	23	108	131	Michoacán
2020-05-26	77	478	555	22	103	125	Michoacán
2020-05-27	85	477	562	18	112	130	Michoacán
2020-05-28	85	478	563	20	111	131	Michoacán
2020-05-29	88	478	566	20	111	131	Michoacán
2020-05-30	86	461	547	18	101	119	Michoacán
2020-05-31	70	383	453	20	88	108	Michoacán
2020-06-01	107	476	583	21	118	139	Michoacán
2020-06-02	111	479	590	21	113	134	Michoacán
2020-06-03	115	466	581	23	121	144	Michoacán
2020-06-04	117	459	576	23	115	138	Michoacán
2020-06-05	128	461	589	24	120	144	Michoacán
2020-06-06	136	472	608	25	110	135	Michoacán
2020-06-07	132	436	568	25	166	191	Michoacán
2020-06-08	126	424	550	25	163	188	Michoacán
2020-06-09	127	432	559	27	159	186	Michoacán
2020-06-10	153	432	585	29	159	188	Michoacán
2020-06-11	178	424	602	34	160	194	Michoacán
2020-06-12	176	412	588	36	157	193	Michoacán
2020-06-13	175	411	586	38	141	179	Michoacán
2020-06-14	189	411	600	33	144	177	Michoacán
2020-06-15	210	389	599	35	150	185	Michoacán
2020-06-16	214	385	599	33	148	181	Michoacán
2020-06-17	239	393	632	35	141	176	Michoacán
2020-06-18	218	398	616	39	143	182	Michoacán
2020-06-19	208	421	629	39	148	187	Michoacán
2020-06-20	198	406	604	39	142	181	Michoacán
2020-06-21	182	420	602	38	153	191	Michoacán
2020-06-22	202	481	683	40	155	195	Michoacán
2020-06-23	234	483	717	44	154	198	Michoacán
2020-06-24	217	490	707	43	152	195	Michoacán
2020-06-25	227	477	704	42	157	199	Michoacán
2020-06-26	208	503	711	45	159	204	Michoacán
2020-06-27	172	513	685	50	162	212	Michoacán
2020-06-28	177	507	684	44	160	204	Michoacán
2020-06-29	183	527	710	41	159	200	Michoacán
2020-06-30	210	514	724	38	162	200	Michoacán
2020-07-01	209	516	725	39	168	207	Michoacán
2020-07-02	213	516	729	36	180	216	Michoacán
2020-07-03	206	529	735	37	189	226	Michoacán
2020-07-04	186	500	686	29	192	221	Michoacán
2020-07-05	191	507	698	33	194	227	Michoacán
2020-07-06	181	503	684	28	185	213	Michoacán
2020-07-07	161	508	669	32	186	218	Michoacán
2020-07-08	190	528	718	41	193	234	Michoacán
2020-07-09	201	540	741	43	198	241	Michoacán
2020-07-10	182	542	724	47	195	242	Michoacán
2020-07-11	162	517	679	46	177	223	Michoacán
2020-07-12	169	537	706	56	187	243	Michoacán
2020-07-13	174	521	695	53	185	238	Michoacán
2020-07-14	211	530	741	49	195	244	Michoacán
2020-07-15	181	523	704	47	186	233	Michoacán
2020-07-16	179	521	700	50	179	229	Michoacán
2020-07-17	193	506	699	51	178	229	Michoacán
2020-07-18	198	480	678	46	173	219	Michoacán
2020-07-19	209	485	694	45	187	232	Michoacán
2020-07-20	221	479	700	48	184	232	Michoacán
2020-07-21	233	452	685	48	179	227	Michoacán
2020-07-22	243	413	656	49	195	244	Michoacán
2020-07-23	236	415	651	52	179	231	Michoacán
2020-07-24	239	446	685	54	183	237	Michoacán
2020-07-25	224	452	676	47	172	219	Michoacán
2020-07-26	246	452	698	54	180	234	Michoacán
2020-07-27	249	445	694	55	184	239	Michoacán
2020-07-28	269	416	685	54	180	234	Michoacán
2020-07-29	241	418	659	60	180	240	Michoacán
2020-07-30	269	413	682	51	185	236	Michoacán
2020-07-31	273	402	675	59	181	240	Michoacán
2020-08-01	221	478	699	55	174	229	Michoacán
2020-08-02	283	410	693	53	187	240	Michoacán
2020-08-03	284	409	693	53	192	245	Michoacán
2020-08-04	279	426	705	43	185	228	Michoacán
2020-08-05	302	465	767	49	194	243	Michoacán
2020-08-06	276	470	746	62	190	252	Michoacán
2020-08-07	255	469	724	65	190	255	Michoacán
2020-08-08	269	484	753	62	195	257	Michoacán
2020-08-09	278	476	754	65	188	253	Michoacán
2020-08-10	295	439	734	58	183	241	Michoacán
2020-08-11	309	466	775	62	183	245	Michoacán
2020-08-12	309	468	777	69	178	247	Michoacán
2020-08-13	282	484	766	78	178	256	Michoacán
2020-08-14	292	484	776	81	196	277	Michoacán
2020-08-15	319	506	825	74	216	290	Michoacán
2020-08-16	334	495	829	81	197	278	Michoacán
2020-08-17	325	485	810	69	193	262	Michoacán
2020-08-18	318	510	828	64	213	277	Michoacán
2020-08-19	325	486	811	67	194	261	Michoacán
2020-08-20	325	482	807	71	201	272	Michoacán
2020-08-21	332	490	822	76	194	270	Michoacán
2020-08-22	318	500	818	70	201	271	Michoacán
2020-08-23	333	462	795	69	196	265	Michoacán
2020-08-24	349	477	826	72	186	258	Michoacán
2020-08-25	354	470	824	74	187	261	Michoacán
2020-08-26	351	480	831	66	193	259	Michoacán
2020-08-27	345	478	823	70	205	275	Michoacán
2020-08-28	345	514	859	73	205	278	Michoacán
2020-08-29	326	516	842	73	200	273	Michoacán
2020-08-30	312	524	836	77	205	282	Michoacán
2020-08-31	324	528	852	82	199	281	Michoacán
2020-09-01	333	483	816	74	197	271	Michoacán
2020-09-02	348	526	874	69	204	273	Michoacán
2020-09-03	336	536	872	68	207	275	Michoacán
2020-09-04	325	553	878	66	212	278	Michoacán
2020-09-05	304	568	872	72	208	280	Michoacán
2020-09-06	323	553	876	68	208	276	Michoacán
2020-04-07	8	69	77	0	94	94	Morelos
2020-04-08	9	68	77	0	93	93	Morelos
2020-04-09	10	67	77	0	58	58	Morelos
2020-04-10	14	65	79	1	57	58	Morelos
2020-04-11	18	65	83	3	55	58	Morelos
2020-04-12	21	62	83	4	55	59	Morelos
2020-04-13	21	62	83	4	54	58	Morelos
2020-04-14	22	62	84	3	56	59	Morelos
2020-04-15	20	61	81	3	56	59	Morelos
2020-04-16	20	61	81	3	58	61	Morelos
2020-04-17	23	58	81	3	56	59	Morelos
2020-04-18	16	64	80	5	52	57	Morelos
2020-04-19	25	60	85	5	53	58	Morelos
2020-04-20	19	64	83	7	50	57	Morelos
2020-04-21	23	70	93	6	74	80	Morelos
2020-04-22	19	79	98	6	61	67	Morelos
2020-04-23	35	309	344	7	63	70	Morelos
2020-04-24	35	308	343	8	62	70	Morelos
2020-04-25	37	310	347	7	62	69	Morelos
2020-04-26	44	309	353	7	66	73	Morelos
2020-04-27	54	301	355	15	66	81	Morelos
2020-04-28	65	298	363	9	44	53	Morelos
2020-04-29	153	308	461	18	64	82	Morelos
2020-04-30	161	308	469	16	64	80	Morelos
2020-05-01	172	309	481	17	65	82	Morelos
2020-05-02	172	315	487	15	67	82	Morelos
2020-05-03	162	319	481	20	66	86	Morelos
2020-05-04	152	326	478	19	67	86	Morelos
2020-05-05	167	324	491	21	66	87	Morelos
2020-05-06	182	326	508	21	66	87	Morelos
2020-05-07	181	330	511	25	63	88	Morelos
2020-05-08	152	331	483	24	63	87	Morelos
2020-05-09	197	325	522	20	65	85	Morelos
2020-05-10	193	315	508	20	68	88	Morelos
2020-05-11	201	323	524	16	70	86	Morelos
2020-05-12	197	320	517	22	72	94	Morelos
2020-05-13	199	322	521	16	80	96	Morelos
2020-05-14	193	338	531	17	62	79	Morelos
2020-05-15	194	332	526	19	90	109	Morelos
2020-05-16	185	330	515	18	85	103	Morelos
2020-05-17	182	327	509	22	84	106	Morelos
2020-05-18	198	331	529	17	77	94	Morelos
2020-05-19	197	329	526	16	83	99	Morelos
2020-05-20	205	341	546	17	81	98	Morelos
2020-05-21	187	335	522	18	84	102	Morelos
2020-05-22	177	334	511	22	79	101	Morelos
2020-05-23	152	340	492	29	75	104	Morelos
2020-05-24	143	340	483	24	77	101	Morelos
2020-05-25	145	340	485	26	78	104	Morelos
2020-05-26	143	340	483	27	76	103	Morelos
2020-05-27	148	127	275	30	71	101	Morelos
2020-05-28	162	193	355	26	78	104	Morelos
2020-05-29	157	169	326	29	80	109	Morelos
2020-05-30	151	124	275	35	73	108	Morelos
2020-05-31	188	149	337	28	73	101	Morelos
2020-06-01	192	167	359	29	80	109	Morelos
2020-06-02	180	117	297	36	71	107	Morelos
2020-06-03	187	155	342	38	73	111	Morelos
2020-06-04	180	165	345	40	72	112	Morelos
2020-06-05	179	156	335	36	70	106	Morelos
2020-06-06	185	163	348	35	75	110	Morelos
2020-06-07	175	158	333	38	79	117	Morelos
2020-06-08	192	157	349	38	79	117	Morelos
2020-06-09	173	198	371	34	76	110	Morelos
2020-06-10	179	190	369	33	77	110	Morelos
2020-06-11	168	155	323	36	74	110	Morelos
2020-06-12	167	196	363	32	69	101	Morelos
2020-06-13	167	190	357	41	72	113	Morelos
2020-06-14	178	190	368	38	70	108	Morelos
2020-06-15	198	194	392	38	73	111	Morelos
2020-06-16	211	174	385	35	69	104	Morelos
2020-06-17	175	143	318	33	69	102	Morelos
2020-06-18	182	199	381	40	72	112	Morelos
2020-06-19	184	198	382	46	68	114	Morelos
2020-06-20	173	199	372	37	77	114	Morelos
2020-06-21	182	204	386	39	70	109	Morelos
2020-06-22	172	214	386	39	77	116	Morelos
2020-06-23	160	191	351	28	77	105	Morelos
2020-06-24	164	214	378	32	82	114	Morelos
2020-06-25	179	199	378	31	93	124	Morelos
2020-06-26	185	227	412	32	86	118	Morelos
2020-06-27	132	234	366	40	83	123	Morelos
2020-06-28	151	255	406	36	87	123	Morelos
2020-06-29	151	298	449	35	117	152	Morelos
2020-06-30	144	301	445	37	115	152	Morelos
2020-07-01	133	326	459	32	119	151	Morelos
2020-07-02	124	322	446	29	126	155	Morelos
2020-07-03	126	331	457	33	125	158	Morelos
2020-07-04	111	346	457	34	117	151	Morelos
2020-07-05	111	347	458	33	115	148	Morelos
2020-07-06	110	332	442	36	120	156	Morelos
2020-07-07	104	327	431	34	127	161	Morelos
2020-07-08	119	322	441	35	120	155	Morelos
2020-07-09	118	347	465	32	107	139	Morelos
2020-07-10	107	339	446	30	122	152	Morelos
2020-07-11	107	346	453	29	124	153	Morelos
2020-07-12	113	343	456	25	127	152	Morelos
2020-07-13	101	306	407	29	94	123	Morelos
2020-07-14	107	340	447	29	126	155	Morelos
2020-07-15	109	312	421	26	125	151	Morelos
2020-07-16	119	327	446	24	129	153	Morelos
2020-07-17	125	313	438	24	120	144	Morelos
2020-07-18	108	274	382	26	131	157	Morelos
2020-07-19	112	322	434	31	122	153	Morelos
2020-07-20	111	304	415	26	110	136	Morelos
2020-07-21	102	281	383	26	93	119	Morelos
2020-07-22	111	277	388	28	95	123	Morelos
2020-07-23	111	280	391	28	92	120	Morelos
2020-07-24	122	275	397	25	93	118	Morelos
2020-07-25	111	280	391	24	99	123	Morelos
2020-07-26	117	272	389	26	98	124	Morelos
2020-07-27	122	279	401	23	100	123	Morelos
2020-07-28	140	294	434	27	120	147	Morelos
2020-07-29	139	301	440	29	120	149	Morelos
2020-07-30	144	284	428	35	119	154	Morelos
2020-07-31	140	290	430	38	116	154	Morelos
2020-08-01	140	297	437	39	115	154	Morelos
2020-08-02	148	291	439	36	112	148	Morelos
2020-08-03	153	245	398	27	94	121	Morelos
2020-08-04	140	283	423	36	116	152	Morelos
2020-08-05	113	261	374	32	91	123	Morelos
2020-08-06	120	266	386	30	94	124	Morelos
2020-08-07	124	298	422	34	117	151	Morelos
2020-08-08	127	314	441	32	122	154	Morelos
2020-08-09	114	327	441	38	120	158	Morelos
2020-08-10	114	267	381	32	93	125	Morelos
2020-08-11	125	261	386	35	116	151	Morelos
2020-08-12	116	297	413	30	112	142	Morelos
2020-08-13	108	311	419	38	116	154	Morelos
2020-08-14	119	330	449	32	124	156	Morelos
2020-08-15	103	332	435	34	128	162	Morelos
2020-08-16	146	348	494	23	124	147	Morelos
2020-08-17	136	322	458	30	125	155	Morelos
2020-08-18	126	327	453	32	127	159	Morelos
2020-08-19	119	327	446	36	128	164	Morelos
2020-08-20	107	334	441	34	131	165	Morelos
2020-08-21	115	341	456	37	114	151	Morelos
2020-08-22	129	331	460	31	111	142	Morelos
2020-08-23	117	318	435	39	130	169	Morelos
2020-08-24	121	343	464	34	115	149	Morelos
2020-08-25	99	319	418	29	113	142	Morelos
2020-08-26	112	287	399	33	122	155	Morelos
2020-08-27	104	294	398	32	125	157	Morelos
2020-08-28	139	343	482	27	127	154	Morelos
2020-08-29	133	249	382	19	99	118	Morelos
2020-08-30	155	326	481	25	114	139	Morelos
2020-08-31	122	301	423	28	114	142	Morelos
2020-09-01	125	343	468	26	113	139	Morelos
2020-09-02	140	337	477	21	121	142	Morelos
2020-09-03	107	334	441	27	119	146	Morelos
2020-09-04	96	336	432	24	95	119	Morelos
2020-09-05	87	376	463	27	120	147	Morelos
2020-09-06	81	340	421	31	89	120	Morelos
2020-04-07	9	4	13	2	15	17	Nayarit
2020-04-08	10	4	14	2	15	17	Nayarit
2020-04-09	8	19	27	2	30	32	Nayarit
2020-04-10	7	19	26	2	32	34	Nayarit
2020-04-11	6	31	37	2	19	21	Nayarit
2020-04-12	0	33	33	2	23	25	Nayarit
2020-04-13	7	24	31	1	28	29	Nayarit
2020-04-14	4	25	29	1	28	29	Nayarit
2020-04-15	4	25	29	1	28	29	Nayarit
2020-04-16	5	25	30	1	29	30	Nayarit
2020-04-17	6	25	31	1	27	28	Nayarit
2020-04-18	6	26	32	1	26	27	Nayarit
2020-04-19	8	26	34	1	26	27	Nayarit
2020-04-20	9	25	34	1	25	26	Nayarit
2020-04-21	5	25	30	1	30	31	Nayarit
2020-04-22	8	23	31	1	41	42	Nayarit
2020-04-23	10	23	33	1	41	42	Nayarit
2020-04-24	6	23	29	2	41	43	Nayarit
2020-04-25	5	23	28	1	41	42	Nayarit
2020-04-26	8	22	30	0	41	41	Nayarit
2020-04-27	6	24	30	1	40	41	Nayarit
2020-04-28	9	24	33	1	29	30	Nayarit
2020-04-29	11	43	54	2	57	59	Nayarit
2020-04-30	10	45	55	1	61	62	Nayarit
2020-05-01	11	96	107	2	64	66	Nayarit
2020-05-02	13	106	119	2	39	41	Nayarit
2020-05-03	16	100	116	2	41	43	Nayarit
2020-05-04	21	104	125	4	41	45	Nayarit
2020-05-05	22	102	124	4	39	43	Nayarit
2020-05-06	24	123	147	4	50	54	Nayarit
2020-05-07	21	99	120	4	36	40	Nayarit
2020-05-08	21	105	126	5	39	44	Nayarit
2020-05-09	24	87	111	3	37	40	Nayarit
2020-05-10	24	102	126	4	39	43	Nayarit
2020-05-11	24	101	125	5	34	39	Nayarit
2020-05-12	26	105	131	4	38	42	Nayarit
2020-05-13	37	105	142	9	52	61	Nayarit
2020-05-14	41	105	146	7	55	62	Nayarit
2020-05-15	40	104	144	11	57	68	Nayarit
2020-05-16	61	95	156	12	41	53	Nayarit
2020-05-17	55	98	153	11	43	54	Nayarit
2020-05-18	51	105	156	12	44	56	Nayarit
2020-05-19	51	105	156	10	43	53	Nayarit
2020-05-20	50	106	156	12	43	55	Nayarit
2020-05-21	39	99	138	11	48	59	Nayarit
2020-05-22	42	98	140	11	54	65	Nayarit
2020-05-23	45	97	142	12	51	63	Nayarit
2020-05-24	47	90	137	17	49	66	Nayarit
2020-05-25	47	96	143	19	47	66	Nayarit
2020-05-26	51	103	154	19	38	57	Nayarit
2020-05-27	47	98	145	22	39	61	Nayarit
2020-05-28	60	85	145	21	44	65	Nayarit
2020-05-29	63	86	149	20	43	63	Nayarit
2020-05-30	57	96	153	21	40	61	Nayarit
2020-05-31	54	76	130	14	47	61	Nayarit
2020-06-01	51	92	143	21	49	70	Nayarit
2020-06-02	58	99	157	20	49	69	Nayarit
2020-06-03	63	85	148	21	50	71	Nayarit
2020-06-04	66	96	162	21	55	76	Nayarit
2020-06-05	62	101	163	20	56	76	Nayarit
2020-06-06	73	89	162	20	54	74	Nayarit
2020-06-07	68	87	155	20	53	73	Nayarit
2020-06-08	69	93	162	21	59	80	Nayarit
2020-06-09	67	79	146	22	61	83	Nayarit
2020-06-10	59	96	155	24	58	82	Nayarit
2020-06-11	65	95	160	25	54	79	Nayarit
2020-06-12	69	91	160	22	52	74	Nayarit
2020-06-13	73	71	144	21	50	71	Nayarit
2020-06-14	68	82	150	26	56	82	Nayarit
2020-06-15	66	90	156	28	64	92	Nayarit
2020-06-16	73	91	164	27	60	87	Nayarit
2020-06-17	72	98	170	30	55	85	Nayarit
2020-06-18	69	102	171	31	53	84	Nayarit
2020-06-19	82	97	179	27	58	85	Nayarit
2020-06-20	80	81	161	24	61	85	Nayarit
2020-06-21	75	91	166	24	62	86	Nayarit
2020-06-22	89	93	182	25	69	94	Nayarit
2020-06-23	87	102	189	27	67	94	Nayarit
2020-06-24	88	100	188	26	65	91	Nayarit
2020-06-25	87	97	184	25	67	92	Nayarit
2020-06-26	81	59	140	23	73	96	Nayarit
2020-06-27	86	74	160	24	79	103	Nayarit
2020-06-28	86	73	159	25	74	99	Nayarit
2020-06-29	124	68	192	26	76	102	Nayarit
2020-06-30	119	78	197	19	82	101	Nayarit
2020-07-01	108	81	189	21	78	99	Nayarit
2020-07-02	117	69	186	19	81	100	Nayarit
2020-07-03	113	39	152	31	80	111	Nayarit
2020-07-04	103	38	141	26	77	103	Nayarit
2020-07-05	134	38	172	30	79	109	Nayarit
2020-07-06	133	46	179	31	83	114	Nayarit
2020-07-07	129	39	168	34	82	116	Nayarit
2020-07-08	131	39	170	34	79	113	Nayarit
2020-07-09	126	40	166	33	78	111	Nayarit
2020-07-10	116	40	156	33	69	102	Nayarit
2020-07-11	124	32	156	30	70	100	Nayarit
2020-07-12	92	36	128	33	69	102	Nayarit
2020-07-13	96	37	133	35	64	99	Nayarit
2020-07-14	119	41	160	35	62	97	Nayarit
2020-07-15	117	40	157	35	62	97	Nayarit
2020-07-16	112	47	159	41	60	101	Nayarit
2020-07-17	107	43	150	43	57	100	Nayarit
2020-07-18	109	41	150	39	58	97	Nayarit
2020-07-19	123	39	162	43	60	103	Nayarit
2020-07-20	128	36	164	38	67	105	Nayarit
2020-07-21	118	36	154	46	62	108	Nayarit
2020-07-22	110	43	153	46	61	107	Nayarit
2020-07-23	126	40	166	38	64	102	Nayarit
2020-07-24	118	42	160	46	61	107	Nayarit
2020-07-25	121	47	168	36	50	86	Nayarit
2020-07-26	103	57	160	42	51	93	Nayarit
2020-07-27	122	41	163	46	60	106	Nayarit
2020-07-28	117	48	165	45	52	97	Nayarit
2020-07-29	118	37	155	41	55	96	Nayarit
2020-07-30	124	44	168	35	69	104	Nayarit
2020-07-31	131	30	161	35	65	100	Nayarit
2020-08-01	135	47	182	36	66	102	Nayarit
2020-08-02	130	52	182	36	65	101	Nayarit
2020-08-03	113	51	164	41	71	112	Nayarit
2020-08-04	140	47	187	32	68	100	Nayarit
2020-08-05	140	38	178	35	53	88	Nayarit
2020-08-06	128	39	167	37	66	103	Nayarit
2020-08-07	135	43	178	34	67	101	Nayarit
2020-08-08	118	46	164	36	66	102	Nayarit
2020-08-09	127	43	170	34	53	87	Nayarit
2020-08-10	115	60	175	45	55	100	Nayarit
2020-08-11	119	61	180	40	84	124	Nayarit
2020-08-12	111	63	174	43	82	125	Nayarit
2020-08-13	104	65	169	41	81	122	Nayarit
2020-08-14	116	63	179	38	78	116	Nayarit
2020-08-15	118	66	184	35	82	117	Nayarit
2020-08-16	110	64	174	36	84	120	Nayarit
2020-08-17	103	64	167	42	80	122	Nayarit
2020-08-18	104	61	165	42	79	121	Nayarit
2020-08-19	116	59	175	36	84	120	Nayarit
2020-08-20	123	61	184	38	79	117	Nayarit
2020-08-21	127	60	187	31	87	118	Nayarit
2020-08-22	124	62	186	29	90	119	Nayarit
2020-08-23	129	60	189	26	92	118	Nayarit
2020-08-24	133	57	190	24	93	117	Nayarit
2020-08-25	126	60	186	26	90	116	Nayarit
2020-08-26	133	62	195	22	93	115	Nayarit
2020-08-27	118	71	189	30	93	123	Nayarit
2020-08-28	126	113	239	23	120	143	Nayarit
2020-08-29	118	107	225	29	112	141	Nayarit
2020-08-30	124	83	207	29	100	129	Nayarit
2020-08-31	127	83	210	26	105	131	Nayarit
2020-09-01	116	86	202	26	115	141	Nayarit
2020-09-02	118	88	206	26	113	139	Nayarit
2020-09-03	117	88	205	29	109	138	Nayarit
2020-09-04	119	89	208	25	115	140	Nayarit
2020-09-05	116	89	205	25	121	146	Nayarit
2020-09-06	108	81	189	27	116	143	Nayarit
2020-04-07	8	450	458	2	191	193	Nuevo León
2020-04-08	7	442	449	1	181	182	Nuevo León
2020-04-09	4	457	461	1	165	166	Nuevo León
2020-04-10	3	442	445	3	161	164	Nuevo León
2020-04-11	13	445	458	3	153	156	Nuevo León
2020-04-12	19	395	414	7	148	155	Nuevo León
2020-04-13	21	384	405	5	161	166	Nuevo León
2020-04-14	22	399	421	6	164	170	Nuevo León
2020-04-15	14	397	411	8	200	208	Nuevo León
2020-04-16	15	395	410	9	194	203	Nuevo León
2020-04-17	18	401	419	10	192	202	Nuevo León
2020-04-18	35	743	778	16	361	377	Nuevo León
2020-04-19	35	742	777	20	349	369	Nuevo León
2020-04-20	43	802	845	17	378	395	Nuevo León
2020-04-21	45	771	816	20	397	417	Nuevo León
2020-04-22	45	955	1,000	20	424	444	Nuevo León
2020-04-23	40	955	995	17	434	451	Nuevo León
2020-04-24	35	808	843	17	401	418	Nuevo León
2020-04-25	62	954	1,016	20	439	459	Nuevo León
2020-04-26	59	953	1,012	20	443	463	Nuevo León
2020-04-27	53	943	996	23	444	467	Nuevo León
2020-04-28	68	985	1,053	20	311	331	Nuevo León
2020-04-29	89	858	947	17	225	242	Nuevo León
2020-04-30	102	988	1,090	24	313	337	Nuevo León
2020-05-01	100	984	1,084	24	299	323	Nuevo León
2020-05-02	108	1020	1,128	29	273	302	Nuevo León
2020-05-03	108	986	1,094	26	274	300	Nuevo León
2020-05-04	116	1027	1,143	26	256	282	Nuevo León
2020-05-05	104	867	971	29	298	327	Nuevo León
2020-05-06	103	866	969	30	293	323	Nuevo León
2020-05-07	112	861	973	29	299	328	Nuevo León
2020-05-08	80	863	943	32	292	324	Nuevo León
2020-05-09	105	862	967	32	288	320	Nuevo León
2020-05-10	108	862	970	34	288	322	Nuevo León
2020-05-11	107	861	968	33	282	315	Nuevo León
2020-05-12	142	862	1,004	36	282	318	Nuevo León
2020-05-13	137	860	997	29	282	311	Nuevo León
2020-05-14	149	854	1,003	32	271	303	Nuevo León
2020-05-15	156	851	1,007	32	282	314	Nuevo León
2020-05-16	147	851	998	34	285	319	Nuevo León
2020-05-17	157	851	1,008	34	284	318	Nuevo León
2020-05-18	178	847	1,025	39	274	313	Nuevo León
2020-05-19	182	809	991	43	276	319	Nuevo León
2020-05-20	184	808	992	40	277	317	Nuevo León
2020-05-21	180	850	1,030	42	268	310	Nuevo León
2020-05-22	178	880	1,058	55	267	322	Nuevo León
2020-05-23	163	911	1,074	57	263	320	Nuevo León
2020-05-24	205	936	1,141	56	260	316	Nuevo León
2020-05-25	213	936	1,149	57	266	323	Nuevo León
2020-05-26	216	929	1,145	59	246	305	Nuevo León
2020-05-27	179	730	909	45	155	200	Nuevo León
2020-05-28	205	824	1,029	65	262	327	Nuevo León
2020-05-29	192	782	974	68	261	329	Nuevo León
2020-05-30	185	790	975	66	256	322	Nuevo León
2020-05-31	199	776	975	67	253	320	Nuevo León
2020-06-01	210	765	975	63	265	328	Nuevo León
2020-06-02	218	760	978	60	269	329	Nuevo León
2020-06-03	209	861	1,070	63	269	332	Nuevo León
2020-06-04	222	856	1,078	62	290	352	Nuevo León
2020-06-05	240	840	1,080	59	294	353	Nuevo León
2020-06-06	248	840	1,088	66	288	354	Nuevo León
2020-06-07	259	837	1,096	72	270	342	Nuevo León
2020-06-08	265	845	1,110	71	265	336	Nuevo León
2020-06-09	259	829	1,088	80	262	342	Nuevo León
2020-06-10	249	843	1,092	75	273	348	Nuevo León
2020-06-11	266	873	1,139	80	268	348	Nuevo León
2020-06-12	287	862	1,149	89	262	351	Nuevo León
2020-06-13	278	873	1,151	86	265	351	Nuevo León
2020-06-14	281	861	1,142	89	273	362	Nuevo León
2020-06-15	307	885	1,192	95	271	366	Nuevo León
2020-06-16	303	872	1,175	108	264	372	Nuevo León
2020-06-17	361	860	1,221	112	257	369	Nuevo León
2020-06-18	394	843	1,237	99	267	366	Nuevo León
2020-06-19	412	759	1,171	104	203	307	Nuevo León
2020-06-20	412	762	1,174	109	214	323	Nuevo León
2020-06-21	447	721	1,168	114	216	330	Nuevo León
2020-06-22	464	693	1,157	119	199	318	Nuevo León
2020-06-23	515	670	1,185	131	169	300	Nuevo León
2020-06-24	523	666	1,189	136	156	292	Nuevo León
2020-06-25	523	690	1,213	142	149	291	Nuevo León
2020-06-26	512	507	1,019	114	155	269	Nuevo León
2020-06-27	577	484	1,061	183	152	335	Nuevo León
2020-06-28	636	451	1,087	176	153	329	Nuevo León
2020-06-29	681	526	1,207	195	146	341	Nuevo León
2020-06-30	678	519	1,197	208	142	350	Nuevo León
2020-07-01	677	490	1,167	202	265	467	Nuevo León
2020-07-02	689	408	1,097	202	161	363	Nuevo León
2020-07-03	752	463	1,215	209	183	392	Nuevo León
2020-07-04	734	370	1,104	225	173	398	Nuevo León
2020-07-05	767	271	1,038	228	175	403	Nuevo León
2020-07-06	783	343	1,126	236	191	427	Nuevo León
2020-07-07	827	352	1,179	229	202	431	Nuevo León
2020-07-08	799	357	1,156	220	241	461	Nuevo León
2020-07-09	858	311	1,169	217	202	419	Nuevo León
2020-07-10	872	232	1,104	217	190	407	Nuevo León
2020-07-11	886	263	1,149	223	173	396	Nuevo León
2020-07-12	862	195	1,057	230	154	384	Nuevo León
2020-07-13	975	283	1,258	246	142	388	Nuevo León
2020-07-14	968	285	1,253	241	122	363	Nuevo León
2020-07-15	1011	299	1,310	251	140	391	Nuevo León
2020-07-16	1027	332	1,359	245	126	371	Nuevo León
2020-07-17	993	308	1,301	240	133	373	Nuevo León
2020-07-18	1028	263	1,291	242	140	382	Nuevo León
2020-07-19	1026	274	1,300	246	160	406	Nuevo León
2020-07-20	1058	343	1,401	254	148	402	Nuevo León
2020-07-21	1033	288	1,321	260	141	401	Nuevo León
2020-07-22	1043	299	1,342	253	209	462	Nuevo León
2020-07-23	1052	258	1,310	247	117	364	Nuevo León
2020-07-24	1039	244	1,283	242	73	315	Nuevo León
2020-07-25	1022	294	1,316	267	123	390	Nuevo León
2020-07-26	1073	280	1,353	258	112	370	Nuevo León
2020-07-27	1050	282	1,332	267	137	404	Nuevo León
2020-07-28	1065	300	1,365	269	126	395	Nuevo León
2020-07-29	1091	408	1,499	271	145	416	Nuevo León
2020-07-30	1104	348	1,452	284	126	410	Nuevo León
2020-07-31	1126	302	1,428	291	214	505	Nuevo León
2020-08-01	1079	370	1,449	277	147	424	Nuevo León
2020-08-02	1119	382	1,501	294	130	424	Nuevo León
2020-08-03	1111	409	1,520	280	144	424	Nuevo León
2020-08-04	990	475	1,465	252	146	398	Nuevo León
2020-08-05	1131	451	1,582	278	150	428	Nuevo León
2020-08-06	959	502	1,461	278	159	437	Nuevo León
2020-08-07	1106	492	1,598	290	159	449	Nuevo León
2020-08-08	1076	477	1,553	280	150	430	Nuevo León
2020-08-09	1094	477	1,571	261	151	412	Nuevo León
2020-08-10	1113	511	1,624	259	200	459	Nuevo León
2020-08-11	1119	504	1,623	260	200	460	Nuevo León
2020-08-12	1108	492	1,600	241	232	473	Nuevo León
2020-08-13	1069	598	1,667	235	230	465	Nuevo León
2020-08-14	1115	641	1,756	263	218	481	Nuevo León
2020-08-15	1058	662	1,720	277	175	452	Nuevo León
2020-08-16	1095	637	1,732	259	184	443	Nuevo León
2020-08-17	928	624	1,552	361	207	568	Nuevo León
2020-08-18	1096	606	1,702	263	207	470	Nuevo León
2020-08-19	1146	629	1,775	252	221	473	Nuevo León
2020-08-20	1110	603	1,713	261	219	480	Nuevo León
2020-08-21	1136	604	1,740	270	219	489	Nuevo León
2020-08-22	1080	619	1,699	268	203	471	Nuevo León
2020-08-23	1084	600	1,684	266	193	459	Nuevo León
2020-08-24	1089	669	1,758	291	230	521	Nuevo León
2020-08-25	1088	642	1,730	285	219	504	Nuevo León
2020-08-26	1051	663	1,714	281	215	496	Nuevo León
2020-08-27	1088	807	1,895	294	241	535	Nuevo León
2020-08-28	1065	623	1,688	298	210	508	Nuevo León
2020-08-29	1092	654	1,746	276	220	496	Nuevo León
2020-08-30	1086	644	1,730	264	231	495	Nuevo León
2020-08-31	1112	608	1,720	270	217	487	Nuevo León
2020-09-01	1050	663	1,713	268	231	499	Nuevo León
2020-09-02	995	741	1,736	260	247	507	Nuevo León
2020-09-03	998	772	1,770	253	257	510	Nuevo León
2020-09-04	1041	707	1,748	249	323	572	Nuevo León
2020-09-05	949	756	1,705	282	345	627	Nuevo León
2020-09-06	1011	740	1,751	270	347	617	Nuevo León
2020-04-01	1	0	1	0	5	5	Oaxaca
2020-04-02	1	0	1	0	11	11	Oaxaca
2020-04-03	2	0	2	0	21	21	Oaxaca
2020-04-04	2	0	2	1	18	19	Oaxaca
2020-04-05	3	0	3	1	17	18	Oaxaca
2020-04-06	1	0	1	1	19	20	Oaxaca
2020-04-07	7	34	41	3	46	49	Oaxaca
2020-04-08	8	37	45	4	41	45	Oaxaca
2020-04-09	7	55	62	4	28	32	Oaxaca
2020-04-10	11	163	174	5	66	71	Oaxaca
2020-04-11	17	166	183	5	67	72	Oaxaca
2020-04-12	63	153	216	4	61	65	Oaxaca
2020-04-13	65	160	225	4	71	75	Oaxaca
2020-04-14	16	161	177	5	59	64	Oaxaca
2020-04-15	22	159	181	2	74	76	Oaxaca
2020-04-16	17	156	173	5	80	85	Oaxaca
2020-04-17	12	157	169	8	77	85	Oaxaca
2020-04-18	16	200	216	7	83	90	Oaxaca
2020-04-19	17	198	215	6	84	90	Oaxaca
2020-04-20	19	192	211	7	91	98	Oaxaca
2020-04-21	24	337	361	5	148	153	Oaxaca
2020-04-22	27	354	381	6	110	116	Oaxaca
2020-04-23	22	333	355	7	108	115	Oaxaca
2020-04-24	22	330	352	12	116	128	Oaxaca
2020-04-25	27	325	352	14	113	127	Oaxaca
2020-04-26	31	333	364	15	132	147	Oaxaca
2020-04-27	23	338	361	8	133	141	Oaxaca
2020-04-28	35	448	483	21	122	143	Oaxaca
2020-04-29	30	377	407	23	122	145	Oaxaca
2020-04-30	35	379	414	27	108	135	Oaxaca
2020-05-01	41	366	407	26	80	106	Oaxaca
2020-05-02	26	350	376	29	97	126	Oaxaca
2020-05-03	34	349	383	28	92	120	Oaxaca
2020-05-04	29	349	378	32	89	121	Oaxaca
2020-05-05	33	348	381	32	89	121	Oaxaca
2020-05-06	37	365	402	31	92	123	Oaxaca
2020-05-07	45	342	387	28	97	125	Oaxaca
2020-05-08	35	345	380	34	103	137	Oaxaca
2020-05-09	35	351	386	31	103	134	Oaxaca
2020-05-10	41	349	390	28	109	137	Oaxaca
2020-05-11	52	337	389	31	96	127	Oaxaca
2020-05-12	50	331	381	35	84	119	Oaxaca
2020-05-13	59	342	401	40	88	128	Oaxaca
2020-05-14	61	276	337	41	82	123	Oaxaca
2020-05-15	75	288	363	46	83	129	Oaxaca
2020-05-16	86	291	377	39	82	121	Oaxaca
2020-05-17	72	175	247	18	39	57	Oaxaca
2020-05-18	88	281	369	43	88	131	Oaxaca
2020-05-19	90	284	374	46	77	123	Oaxaca
2020-05-20	110	311	421	35	73	108	Oaxaca
2020-05-21	112	300	412	35	78	113	Oaxaca
2020-05-22	122	293	415	36	71	107	Oaxaca
2020-05-23	122	252	374	43	69	112	Oaxaca
2020-05-24	126	283	409	42	74	116	Oaxaca
2020-05-25	132	291	423	42	78	120	Oaxaca
2020-05-26	124	312	436	42	79	121	Oaxaca
2020-05-27	134	306	440	40	84	124	Oaxaca
2020-05-28	124	294	418	41	84	125	Oaxaca
2020-05-29	130	272	402	36	71	107	Oaxaca
2020-05-30	129	297	426	38	72	110	Oaxaca
2020-05-31	130	311	441	39	70	109	Oaxaca
2020-06-01	121	320	441	37	71	108	Oaxaca
2020-06-02	130	231	361	38	71	109	Oaxaca
2020-06-03	149	226	375	44	92	136	Oaxaca
2020-06-04	175	232	407	43	83	126	Oaxaca
2020-06-05	186	241	427	39	81	120	Oaxaca
2020-06-06	151	190	341	44	71	115	Oaxaca
2020-06-07	179	259	438	46	76	122	Oaxaca
2020-06-08	180	227	407	50	76	126	Oaxaca
2020-06-09	179	236	415	56	80	136	Oaxaca
2020-06-10	170	225	395	60	78	138	Oaxaca
2020-06-11	165	233	398	68	71	139	Oaxaca
2020-06-12	151	220	371	67	71	138	Oaxaca
2020-06-13	152	213	365	63	71	134	Oaxaca
2020-06-14	161	235	396	63	68	131	Oaxaca
2020-06-15	177	226	403	65	74	139	Oaxaca
2020-06-16	176	226	402	71	63	134	Oaxaca
2020-06-17	187	217	404	67	66	133	Oaxaca
2020-06-18	169	247	416	65	73	138	Oaxaca
2020-06-19	179	205	384	70	91	161	Oaxaca
2020-06-20	177	254	431	76	83	159	Oaxaca
2020-06-21	177	304	481	80	102	182	Oaxaca
2020-06-22	181	285	466	82	101	183	Oaxaca
2020-06-23	167	303	470	80	95	175	Oaxaca
2020-06-24	171	302	473	81	101	182	Oaxaca
2020-06-25	167	313	480	75	108	183	Oaxaca
2020-06-26	167	334	501	76	111	187	Oaxaca
2020-06-27	162	301	463	74	110	184	Oaxaca
2020-06-28	146	300	446	75	116	191	Oaxaca
2020-06-29	161	290	451	74	137	211	Oaxaca
2020-06-30	171	303	474	62	150	212	Oaxaca
2020-07-01	170	308	478	84	152	236	Oaxaca
2020-07-02	161	251	412	82	145	227	Oaxaca
2020-07-03	165	320	485	89	165	254	Oaxaca
2020-07-04	158	331	489	85	152	237	Oaxaca
2020-07-05	154	307	461	86	152	238	Oaxaca
2020-07-06	163	361	524	81	158	239	Oaxaca
2020-07-07	173	336	509	72	148	220	Oaxaca
2020-07-08	192	342	534	74	146	220	Oaxaca
2020-07-09	189	328	517	72	134	206	Oaxaca
2020-07-10	191	356	547	76	123	199	Oaxaca
2020-07-11	215	340	555	76	126	202	Oaxaca
2020-07-12	213	315	528	76	124	200	Oaxaca
2020-07-13	204	314	518	83	149	232	Oaxaca
2020-07-14	195	351	546	74	147	221	Oaxaca
2020-07-15	191	333	524	73	151	224	Oaxaca
2020-07-16	222	342	564	72	132	204	Oaxaca
2020-07-17	215	322	537	71	139	210	Oaxaca
2020-07-18	209	290	499	71	134	205	Oaxaca
2020-07-19	201	317	518	64	144	208	Oaxaca
2020-07-20	227	313	540	67	142	209	Oaxaca
2020-07-21	224	308	532	70	138	208	Oaxaca
2020-07-22	227	318	545	74	138	212	Oaxaca
2020-07-23	215	323	538	63	150	213	Oaxaca
2020-07-24	189	325	514	69	148	217	Oaxaca
2020-07-25	199	331	530	71	156	227	Oaxaca
2020-07-26	217	329	546	68	153	221	Oaxaca
2020-07-27	207	327	534	72	157	229	Oaxaca
2020-07-28	205	317	522	65	148	213	Oaxaca
2020-07-29	208	324	532	64	150	214	Oaxaca
2020-07-30	219	316	535	68	152	220	Oaxaca
2020-07-31	222	314	536	62	159	221	Oaxaca
2020-08-01	223	315	538	66	157	223	Oaxaca
2020-08-02	233	332	565	62	158	220	Oaxaca
2020-08-03	191	329	520	65	156	221	Oaxaca
2020-08-04	205	327	532	72	150	222	Oaxaca
2020-08-05	199	316	515	71	152	223	Oaxaca
2020-08-06	197	324	521	70	162	232	Oaxaca
2020-08-07	190	320	510	68	170	238	Oaxaca
2020-08-08	191	302	493	74	160	234	Oaxaca
2020-08-09	184	303	487	74	165	239	Oaxaca
2020-08-10	167	306	473	66	176	242	Oaxaca
2020-08-11	177	333	510	62	183	245	Oaxaca
2020-08-12	166	316	482	77	159	236	Oaxaca
2020-08-13	175	340	515	75	160	235	Oaxaca
2020-08-14	167	327	494	78	164	242	Oaxaca
2020-08-15	161	297	458	79	163	242	Oaxaca
2020-08-16	168	327	495	79	162	241	Oaxaca
2020-08-17	153	335	488	79	173	252	Oaxaca
2020-08-18	153	325	478	67	178	245	Oaxaca
2020-08-19	143	352	495	66	181	247	Oaxaca
2020-08-20	136	335	471	67	177	244	Oaxaca
2020-08-21	134	364	498	63	181	244	Oaxaca
2020-08-22	147	334	481	64	168	232	Oaxaca
2020-08-23	164	336	500	60	150	210	Oaxaca
2020-08-24	150	395	545	59	175	234	Oaxaca
2020-08-25	142	355	497	64	178	242	Oaxaca
2020-08-26	134	326	460	67	178	245	Oaxaca
2020-08-27	143	358	501	65	179	244	Oaxaca
2020-08-28	155	341	496	64	168	232	Oaxaca
2020-08-29	141	320	461	62	169	231	Oaxaca
2020-08-30	140	361	501	62	168	230	Oaxaca
2020-08-31	132	362	494	60	178	238	Oaxaca
2020-09-01	134	347	481	60	180	240	Oaxaca
2020-09-02	128	325	453	61	192	253	Oaxaca
2020-09-03	131	352	483	62	183	245	Oaxaca
2020-09-04	125	350	475	60	170	230	Oaxaca
2020-09-05	148	341	489	52	186	238	Oaxaca
2020-09-06	162	328	490	57	184	241	Oaxaca
2020-04-07	24	100	124	3	149	152	Puebla
2020-04-08	22	99	121	3	148	151	Puebla
2020-04-09	17	97	114	5	137	142	Puebla
2020-04-10	21	90	111	3	132	135	Puebla
2020-04-11	16	88	104	2	130	132	Puebla
2020-04-12	21	89	110	1	132	133	Puebla
2020-04-13	74	314	388	9	221	230	Puebla
2020-04-14	33	115	148	2	143	145	Puebla
2020-04-15	24	79	103	4	129	133	Puebla
2020-04-16	33	307	340	11	161	172	Puebla
2020-04-17	30	485	515	9	164	173	Puebla
2020-04-18	49	555	604	15	169	184	Puebla
2020-04-19	52	582	634	20	172	192	Puebla
2020-04-20	56	734	790	16	180	196	Puebla
2020-04-21	57	757	814	12	267	279	Puebla
2020-04-22	35	607	642	8	172	180	Puebla
2020-04-23	95	806	901	13	280	293	Puebla
2020-04-24	87	759	846	16	256	272	Puebla
2020-04-25	96	742	838	25	241	266	Puebla
2020-04-26	103	737	840	27	250	277	Puebla
2020-04-27	98	691	789	28	232	260	Puebla
2020-04-28	104	726	830	29	166	195	Puebla
2020-04-29	109	766	875	30	139	169	Puebla
2020-04-30	116	883	999	33	181	214	Puebla
2020-05-01	137	883	1,020	33	168	201	Puebla
2020-05-02	142	785	927	33	137	170	Puebla
2020-05-03	169	838	1,007	34	232	266	Puebla
2020-05-04	183	876	1,059	37	154	191	Puebla
2020-05-05	176	540	716	37	135	172	Puebla
2020-05-06	182	605	787	47	165	212	Puebla
2020-05-07	200	617	817	47	261	308	Puebla
2020-05-08	182	685	867	57	175	232	Puebla
2020-05-09	187	719	906	53	189	242	Puebla
2020-05-10	191	663	854	51	170	221	Puebla
2020-05-11	216	653	869	60	158	218	Puebla
2020-05-12	195	526	721	73	171	244	Puebla
2020-05-13	207	500	707	59	157	216	Puebla
2020-05-14	202	490	692	65	141	206	Puebla
2020-05-15	217	488	705	67	157	224	Puebla
2020-05-16	221	473	694	67	166	233	Puebla
2020-05-17	245	463	708	68	158	226	Puebla
2020-05-18	257	444	701	76	159	235	Puebla
2020-05-19	263	457	720	75	168	243	Puebla
2020-05-20	246	459	705	79	158	237	Puebla
2020-05-21	292	421	713	73	164	237	Puebla
2020-05-22	295	415	710	76	164	240	Puebla
2020-05-23	284	421	705	76	166	242	Puebla
2020-05-24	304	396	700	89	158	247	Puebla
2020-05-25	314	383	697	88	162	250	Puebla
2020-05-26	300	401	701	97	158	255	Puebla
2020-05-27	307	423	730	104	147	251	Puebla
2020-05-28	304	422	726	126	135	261	Puebla
2020-05-29	309	431	740	125	136	261	Puebla
2020-05-30	321	417	738	124	139	263	Puebla
2020-05-31	349	383	732	116	137	253	Puebla
2020-06-01	327	412	739	125	131	256	Puebla
2020-06-02	332	336	668	115	148	263	Puebla
2020-06-03	313	355	668	115	144	259	Puebla
2020-06-04	304	363	667	117	144	261	Puebla
2020-06-05	305	384	689	115	135	250	Puebla
2020-06-06	306	369	675	120	142	262	Puebla
2020-06-07	350	351	701	107	154	261	Puebla
2020-06-08	357	344	701	122	144	266	Puebla
2020-06-09	337	358	695	130	133	263	Puebla
2020-06-10	337	357	694	135	139	274	Puebla
2020-06-11	285	328	613	100	94	194	Puebla
2020-06-12	359	334	693	128	134	262	Puebla
2020-06-13	348	333	681	136	133	269	Puebla
2020-06-14	410	294	704	142	155	297	Puebla
2020-06-15	403	331	734	123	133	256	Puebla
2020-06-16	391	374	765	140	136	276	Puebla
2020-06-17	398	329	727	138	134	272	Puebla
2020-06-18	407	335	742	124	150	274	Puebla
2020-06-19	414	324	738	133	138	271	Puebla
2020-06-20	405	325	730	141	142	283	Puebla
2020-06-21	429	357	786	137	149	286	Puebla
2020-06-22	427	373	800	127	154	281	Puebla
2020-06-23	439	352	791	127	161	288	Puebla
2020-06-24	454	336	790	122	160	282	Puebla
2020-06-25	443	358	801	136	154	290	Puebla
2020-06-26	460	346	806	139	144	283	Puebla
2020-06-27	287	181	468	72	62	134	Puebla
2020-06-28	477	335	812	153	139	292	Puebla
2020-06-29	515	312	827	142	143	285	Puebla
2020-06-30	493	314	807	137	150	287	Puebla
2020-07-01	499	310	809	146	142	288	Puebla
2020-07-02	492	318	810	139	164	303	Puebla
2020-07-03	472	302	774	149	133	282	Puebla
2020-07-04	296	179	475	74	68	142	Puebla
2020-07-05	494	310	804	138	143	281	Puebla
2020-07-06	514	317	831	132	153	285	Puebla
2020-07-07	528	299	827	131	159	290	Puebla
2020-07-08	544	291	835	141	153	294	Puebla
2020-07-09	545	373	918	149	161	310	Puebla
2020-07-10	564	375	939	165	129	294	Puebla
2020-07-11	583	445	1,028	159	154	313	Puebla
2020-07-12	604	320	924	154	164	318	Puebla
2020-07-13	608	332	940	153	154	307	Puebla
2020-07-14	586	341	927	156	159	315	Puebla
2020-07-15	601	329	930	155	148	303	Puebla
2020-07-16	619	334	953	153	150	303	Puebla
2020-07-17	616	324	940	168	148	316	Puebla
2020-07-18	615	314	929	176	145	321	Puebla
2020-07-19	631	306	937	171	161	332	Puebla
2020-07-20	655	288	943	162	158	320	Puebla
2020-07-21	648	286	934	163	159	322	Puebla
2020-07-22	635	312	947	164	155	319	Puebla
2020-07-23	605	295	900	167	142	309	Puebla
2020-07-24	604	343	947	177	138	315	Puebla
2020-07-25	615	341	956	172	141	313	Puebla
2020-07-26	624	324	948	169	129	298	Puebla
2020-07-27	628	331	959	174	111	285	Puebla
2020-07-28	626	383	1,009	144	126	270	Puebla
2020-07-29	578	376	954	185	129	314	Puebla
2020-07-30	611	391	1,002	143	141	284	Puebla
2020-07-31	616	398	1,014	140	138	278	Puebla
2020-08-01	604	406	1,010	138	150	288	Puebla
2020-08-02	619	393	1,012	126	156	282	Puebla
2020-08-03	611	392	1,003	132	157	289	Puebla
2020-08-04	593	419	1,012	129	153	282	Puebla
2020-08-05	570	439	1,009	127	158	285	Puebla
2020-08-06	570	425	995	130	153	283	Puebla
2020-08-07	571	447	1,018	121	151	272	Puebla
2020-08-08	549	468	1,017	113	165	278	Puebla
2020-08-09	571	459	1,030	114	158	272	Puebla
2020-08-10	554	451	1,005	117	160	277	Puebla
2020-08-11	542	492	1,034	108	169	277	Puebla
2020-08-12	537	501	1,038	112	167	279	Puebla
2020-08-13	546	481	1,027	106	168	274	Puebla
2020-08-14	534	560	1,094	107	180	287	Puebla
2020-08-15	533	567	1,100	102	184	286	Puebla
2020-08-16	521	572	1,093	92	195	287	Puebla
2020-08-17	297	265	562	54	84	138	Puebla
2020-08-18	501	574	1,075	111	208	319	Puebla
2020-08-19	493	609	1,102	111	209	320	Puebla
2020-08-20	483	603	1,086	109	213	322	Puebla
2020-08-21	472	609	1,081	106	216	322	Puebla
2020-08-22	454	608	1,062	112	216	328	Puebla
2020-08-23	494	598	1,092	90	202	292	Puebla
2020-08-24	473	588	1,061	123	203	326	Puebla
2020-08-25	442	626	1,068	124	199	323	Puebla
2020-08-26	433	665	1,098	129	194	323	Puebla
2020-08-27	416	695	1,111	132	198	330	Puebla
2020-08-28	398	684	1,082	128	200	328	Puebla
2020-08-29	408	705	1,113	95	210	305	Puebla
2020-08-30	426	676	1,102	94	208	302	Puebla
2020-08-31	403	656	1,059	126	205	331	Puebla
2020-09-01	394	680	1,074	119	204	323	Puebla
2020-09-02	357	730	1,087	118	203	321	Puebla
2020-09-03	365	720	1,085	115	216	331	Puebla
2020-09-04	362	712	1,074	109	209	318	Puebla
2020-09-05	391	730	1,121	78	214	292	Puebla
2020-09-06	383	722	1,105	70	226	296	Puebla
2020-04-07	10	38	48	1	29	30	Querétaro
2020-04-08	10	46	56	1	37	38	Querétaro
2020-04-09	11	147	158	5	125	130	Querétaro
2020-04-10	14	121	135	5	154	159	Querétaro
2020-04-11	8	126	134	5	108	113	Querétaro
2020-04-12	10	114	124	2	109	111	Querétaro
2020-04-13	8	117	125	2	114	116	Querétaro
2020-04-14	12	204	216	5	235	240	Querétaro
2020-04-15	8	116	124	2	120	122	Querétaro
2020-04-16	7	104	111	0	116	116	Querétaro
2020-04-17	6	104	110	0	114	114	Querétaro
2020-04-18	6	106	112	0	111	111	Querétaro
2020-04-19	6	106	112	0	113	113	Querétaro
2020-04-20	7	182	189	5	240	245	Querétaro
2020-04-21	7	262	269	5	419	424	Querétaro
2020-04-22	7	437	444	5	189	194	Querétaro
2020-04-23	6	315	321	3	124	127	Querétaro
2020-04-24	6	315	321	3	124	127	Querétaro
2020-04-25	10	415	425	8	219	227	Querétaro
2020-04-26	11	412	423	6	222	228	Querétaro
2020-04-27	12	409	421	7	221	228	Querétaro
2020-04-28	8	406	414	10	178	188	Querétaro
2020-04-29	18	419	437	11	175	186	Querétaro
2020-04-30	21	418	439	9	179	188	Querétaro
2020-05-01	21	418	439	10	173	183	Querétaro
2020-05-02	24	413	437	12	157	169	Querétaro
2020-05-03	27	412	439	15	149	164	Querétaro
2020-05-04	24	415	439	17	155	172	Querétaro
2020-05-05	21	414	435	19	152	171	Querétaro
2020-05-06	21	376	397	22	146	168	Querétaro
2020-05-07	25	349	374	21	145	166	Querétaro
2020-05-08	15	358	373	26	142	168	Querétaro
2020-05-09	30	349	379	26	134	160	Querétaro
2020-05-10	24	349	373	28	132	160	Querétaro
2020-05-11	23	344	367	28	131	159	Querétaro
2020-05-12	42	348	390	28	130	158	Querétaro
2020-05-13	48	340	388	27	131	158	Querétaro
2020-05-14	53	348	401	30	128	158	Querétaro
2020-05-15	63	348	411	29	128	157	Querétaro
2020-05-16	55	264	319	12	39	51	Querétaro
2020-05-17	71	345	416	26	127	153	Querétaro
2020-05-18	70	342	412	29	128	157	Querétaro
2020-05-19	85	340	425	30	132	162	Querétaro
2020-05-20	87	335	422	31	125	156	Querétaro
2020-05-21	101	336	437	32	122	154	Querétaro
2020-05-22	100	339	439	33	123	156	Querétaro
2020-05-23	85	335	420	44	135	179	Querétaro
2020-05-24	69	265	334	22	54	76	Querétaro
2020-05-25	76	332	408	46	129	175	Querétaro
2020-05-26	87	386	473	34	144	178	Querétaro
2020-05-27	77	352	429	39	140	179	Querétaro
2020-05-28	57	192	249	17	58	75	Querétaro
2020-05-29	90	236	326	45	132	177	Querétaro
2020-05-30	52	191	243	20	54	74	Querétaro
2020-05-31	88	250	338	42	126	168	Querétaro
2020-06-01	87	195	282	53	118	171	Querétaro
2020-06-02	94	239	333	58	114	172	Querétaro
2020-06-03	59	185	244	28	47	75	Querétaro
2020-06-04	69	228	297	64	109	173	Querétaro
2020-06-05	61	180	241	31	49	80	Querétaro
2020-06-06	98	248	346	58	115	173	Querétaro
2020-06-07	102	247	349	59	111	170	Querétaro
2020-06-08	93	241	334	64	112	176	Querétaro
2020-06-09	103	238	341	62	101	163	Querétaro
2020-06-10	74	170	244	36	35	71	Querétaro
2020-06-11	154	231	385	66	104	170	Querétaro
2020-06-12	147	231	378	69	105	174	Querétaro
2020-06-13	66	169	235	44	67	111	Querétaro
2020-06-14	68	169	237	44	62	106	Querétaro
2020-06-15	99	232	331	71	133	204	Querétaro
2020-06-16	103	234	337	73	130	203	Querétaro
2020-06-17	130	365	495	81	125	206	Querétaro
2020-06-18	104	366	470	82	118	200	Querétaro
2020-06-19	114	372	486	80	114	194	Querétaro
2020-06-20	107	383	490	81	109	190	Querétaro
2020-06-21	127	457	584	77	155	232	Querétaro
2020-06-22	115	449	564	74	156	230	Querétaro
2020-06-23	121	452	573	70	155	225	Querétaro
2020-06-24	118	458	576	68	158	226	Querétaro
2020-06-25	118	458	576	72	157	229	Querétaro
2020-06-26	120	456	576	71	154	225	Querétaro
2020-06-27	119	503	622	70	164	234	Querétaro
2020-06-28	112	478	590	69	166	235	Querétaro
2020-06-29	111	510	621	65	169	234	Querétaro
2020-06-30	127	510	637	65	170	235	Querétaro
2020-07-01	136	553	689	66	173	239	Querétaro
2020-07-02	136	550	686	69	169	238	Querétaro
2020-07-03	125	552	677	69	171	240	Querétaro
2020-07-04	116	558	674	77	164	241	Querétaro
2020-07-05	111	563	674	73	171	244	Querétaro
2020-07-06	115	558	673	77	166	243	Querétaro
2020-07-07	121	552	673	73	168	241	Querétaro
2020-07-08	130	548	678	74	166	240	Querétaro
2020-07-09	122	550	672	71	172	243	Querétaro
2020-07-10	147	535	682	68	174	242	Querétaro
2020-07-11	124	541	665	78	167	245	Querétaro
2020-07-12	127	536	663	85	161	246	Querétaro
2020-07-13	114	539	653	85	157	242	Querétaro
2020-07-14	131	536	667	79	164	243	Querétaro
2020-07-15	135	531	666	82	163	245	Querétaro
2020-07-16	144	531	675	82	160	242	Querétaro
2020-07-17	145	531	676	79	162	241	Querétaro
2020-07-18	148	530	678	82	164	246	Querétaro
2020-07-19	155	527	682	84	163	247	Querétaro
2020-07-20	152	517	669	80	164	244	Querétaro
2020-07-21	163	446	609	75	203	278	Querétaro
2020-07-22	148	450	598	79	198	277	Querétaro
2020-07-23	157	452	609	75	197	272	Querétaro
2020-07-24	156	451	607	75	200	275	Querétaro
2020-07-25	142	447	589	75	200	275	Querétaro
2020-07-26	150	440	590	74	206	280	Querétaro
2020-07-27	156	447	603	76	209	285	Querétaro
2020-07-28	167	452	619	80	203	283	Querétaro
2020-07-29	177	456	633	77	203	280	Querétaro
2020-07-30	175	453	628	77	205	282	Querétaro
2020-07-31	163	414	577	72	209	281	Querétaro
2020-08-01	167	393	560	77	205	282	Querétaro
2020-08-02	160	463	623	70	205	275	Querétaro
2020-08-03	155	466	621	76	206	282	Querétaro
2020-08-04	173	455	628	75	209	284	Querétaro
2020-08-05	166	437	603	81	208	289	Querétaro
2020-08-06	154	473	627	85	206	291	Querétaro
2020-08-07	136	472	608	84	207	291	Querétaro
2020-08-08	144	466	610	85	204	289	Querétaro
2020-08-09	114	475	589	86	210	296	Querétaro
2020-08-10	138	460	598	86	213	299	Querétaro
2020-08-11	143	461	604	84	215	299	Querétaro
2020-08-12	151	456	607	86	209	295	Querétaro
2020-08-13	158	448	606	87	210	297	Querétaro
2020-08-14	174	434	608	92	200	292	Querétaro
2020-08-15	153	423	576	93	196	289	Querétaro
2020-08-16	155	417	572	93	197	290	Querétaro
2020-08-17	166	405	571	91	196	287	Querétaro
2020-08-18	181	401	582	93	189	282	Querétaro
2020-08-19	177	400	577	98	186	284	Querétaro
2020-08-20	189	411	600	92	191	283	Querétaro
2020-08-21	191	410	601	97	185	282	Querétaro
2020-08-22	162	429	591	97	186	283	Querétaro
2020-08-23	146	418	564	88	195	283	Querétaro
2020-08-24	150	419	569	86	196	282	Querétaro
2020-08-25	160	415	575	94	191	285	Querétaro
2020-08-26	163	415	578	97	192	289	Querétaro
2020-08-27	168	415	583	92	194	286	Querétaro
2020-08-28	165	409	574	98	192	290	Querétaro
2020-08-29	154	413	567	95	191	286	Querétaro
2020-08-30	163	414	577	86	198	284	Querétaro
2020-08-31	151	422	573	83	201	284	Querétaro
2020-09-01	159	413	572	89	197	286	Querétaro
2020-09-02	175	401	576	86	194	280	Querétaro
2020-09-03	174	396	570	91	191	282	Querétaro
2020-09-04	171	395	566	96	189	285	Querétaro
2020-09-05	162	402	564	91	195	286	Querétaro
2020-09-06	168	403	571	90	191	281	Querétaro
2020-04-07	47	112	159	11	69	80	Quintana Roo
2020-04-08	47	112	159	11	69	80	Quintana Roo
2020-04-09	40	202	242	8	73	81	Quintana Roo
2020-04-10	42	216	258	10	73	83	Quintana Roo
2020-04-11	36	230	266	8	66	74	Quintana Roo
2020-04-12	37	230	267	8	59	67	Quintana Roo
2020-04-13	37	242	279	7	68	75	Quintana Roo
2020-04-14	45	242	287	5	71	76	Quintana Roo
2020-04-15	44	242	286	5	87	92	Quintana Roo
2020-04-16	38	239	277	7	75	82	Quintana Roo
2020-04-17	77	95	172	12	110	122	Quintana Roo
2020-04-18	77	145	222	17	121	138	Quintana Roo
2020-04-19	87	127	214	18	106	124	Quintana Roo
2020-04-20	104	141	245	18	99	117	Quintana Roo
2020-04-21	108	216	324	20	204	224	Quintana Roo
2020-04-22	116	225	341	26	130	156	Quintana Roo
2020-04-23	121	219	340	31	129	160	Quintana Roo
2020-04-24	121	221	342	34	129	163	Quintana Roo
2020-04-25	91	220	311	32	129	161	Quintana Roo
2020-04-26	40	183	223	21	108	129	Quintana Roo
2020-04-27	105	267	372	35	141	176	Quintana Roo
2020-04-28	113	209	322	38	92	130	Quintana Roo
2020-04-29	133	148	281	40	75	115	Quintana Roo
2020-04-30	131	195	326	39	75	114	Quintana Roo
2020-05-01	109	196	305	36	79	115	Quintana Roo
2020-05-02	129	195	324	35	95	130	Quintana Roo
2020-05-03	126	196	322	36	90	126	Quintana Roo
2020-05-04	150	196	346	40	90	130	Quintana Roo
2020-05-05	161	197	358	36	83	119	Quintana Roo
2020-05-06	152	198	350	38	81	119	Quintana Roo
2020-05-07	141	196	337	40	75	115	Quintana Roo
2020-05-08	144	194	338	43	80	123	Quintana Roo
2020-05-09	131	195	326	44	79	123	Quintana Roo
2020-05-10	133	195	328	46	78	124	Quintana Roo
2020-05-11	138	201	339	46	84	130	Quintana Roo
2020-05-12	141	214	355	44	83	127	Quintana Roo
2020-05-13	133	219	352	47	83	130	Quintana Roo
2020-05-14	115	225	340	39	90	129	Quintana Roo
2020-05-15	110	204	314	32	97	129	Quintana Roo
2020-05-16	104	213	317	29	91	120	Quintana Roo
2020-05-17	145	206	351	38	92	130	Quintana Roo
2020-05-18	104	210	314	34	98	132	Quintana Roo
2020-05-19	111	216	327	27	100	127	Quintana Roo
2020-05-20	110	218	328	25	98	123	Quintana Roo
2020-05-21	114	210	324	27	89	116	Quintana Roo
2020-05-22	110	205	315	30	94	124	Quintana Roo
2020-05-23	110	210	320	26	98	124	Quintana Roo
2020-05-24	118	198	316	27	94	121	Quintana Roo
2020-05-25	131	195	326	28	98	126	Quintana Roo
2020-05-26	136	185	321	28	99	127	Quintana Roo
2020-05-27	115	195	310	35	95	130	Quintana Roo
2020-05-28	122	202	324	34	98	132	Quintana Roo
2020-05-29	109	205	314	36	95	131	Quintana Roo
2020-05-30	96	206	302	40	89	129	Quintana Roo
2020-05-31	92	203	295	45	89	134	Quintana Roo
2020-06-01	103	214	317	43	91	134	Quintana Roo
2020-06-02	98	206	304	39	98	137	Quintana Roo
2020-06-03	95	224	319	36	99	135	Quintana Roo
2020-06-04	96	219	315	39	98	137	Quintana Roo
2020-06-05	104	205	309	41	95	136	Quintana Roo
2020-06-06	110	238	348	45	117	162	Quintana Roo
2020-06-07	94	196	290	46	87	133	Quintana Roo
2020-06-08	95	247	342	41	128	169	Quintana Roo
2020-06-09	98	380	478	42	119	161	Quintana Roo
2020-06-10	97	380	477	38	132	170	Quintana Roo
2020-06-11	100	417	517	36	192	228	Quintana Roo
2020-06-12	104	422	526	34	192	226	Quintana Roo
2020-06-13	99	425	524	36	196	232	Quintana Roo
2020-06-14	102	421	523	36	192	228	Quintana Roo
2020-06-15	114	420	534	37	191	228	Quintana Roo
2020-06-16	123	412	535	34	200	234	Quintana Roo
2020-06-17	135	467	602	43	205	248	Quintana Roo
2020-06-18	133	477	610	53	195	248	Quintana Roo
2020-06-19	131	489	620	61	193	254	Quintana Roo
2020-06-20	133	498	631	61	190	251	Quintana Roo
2020-06-21	136	443	579	56	188	244	Quintana Roo
2020-06-22	143	470	613	61	198	259	Quintana Roo
2020-06-23	155	469	624	58	199	257	Quintana Roo
2020-06-24	144	481	625	62	192	254	Quintana Roo
2020-06-25	151	471	622	65	188	253	Quintana Roo
2020-06-26	156	473	629	70	183	253	Quintana Roo
2020-06-27	150	453	603	62	185	247	Quintana Roo
2020-06-28	155	445	600	65	187	252	Quintana Roo
2020-06-29	159	453	612	73	180	253	Quintana Roo
2020-06-30	172	460	632	66	182	248	Quintana Roo
2020-07-01	184	461	645	72	185	257	Quintana Roo
2020-07-02	187	457	644	77	188	265	Quintana Roo
2020-07-03	214	423	637	80	195	275	Quintana Roo
2020-07-04	199	402	601	87	196	283	Quintana Roo
2020-07-05	225	403	628	84	184	268	Quintana Roo
2020-07-06	216	374	590	87	178	265	Quintana Roo
2020-07-07	256	412	668	96	195	291	Quintana Roo
2020-07-08	266	384	650	96	184	280	Quintana Roo
2020-07-09	256	409	665	96	181	277	Quintana Roo
2020-07-10	265	401	666	92	180	272	Quintana Roo
2020-07-11	288	421	709	93	186	279	Quintana Roo
2020-07-12	284	409	693	90	188	278	Quintana Roo
2020-07-13	273	393	666	96	180	276	Quintana Roo
2020-07-14	290	408	698	89	185	274	Quintana Roo
2020-07-15	307	410	717	81	187	268	Quintana Roo
2020-07-16	305	396	701	90	185	275	Quintana Roo
2020-07-17	281	384	665	89	175	264	Quintana Roo
2020-07-18	283	378	661	99	171	270	Quintana Roo
2020-07-19	271	361	632	91	164	255	Quintana Roo
2020-07-20	329	388	717	97	175	272	Quintana Roo
2020-07-21	298	389	687	106	168	274	Quintana Roo
2020-07-22	301	381	682	110	158	268	Quintana Roo
2020-07-23	302	394	696	108	168	276	Quintana Roo
2020-07-24	294	405	699	113	168	281	Quintana Roo
2020-07-25	294	380	674	105	169	274	Quintana Roo
2020-07-26	320	402	722	104	178	282	Quintana Roo
2020-07-27	331	397	728	108	178	286	Quintana Roo
2020-07-28	295	380	675	110	175	285	Quintana Roo
2020-07-29	305	406	711	114	183	297	Quintana Roo
2020-07-30	307	400	707	105	190	295	Quintana Roo
2020-07-31	249	375	624	97	163	260	Quintana Roo
2020-08-01	276	387	663	107	183	290	Quintana Roo
2020-08-02	291	409	700	107	195	302	Quintana Roo
2020-08-03	279	412	691	110	200	310	Quintana Roo
2020-08-04	285	439	724	111	200	311	Quintana Roo
2020-08-05	261	439	700	109	193	302	Quintana Roo
2020-08-06	257	409	666	106	187	293	Quintana Roo
2020-08-07	250	446	696	102	201	303	Quintana Roo
2020-08-08	237	438	675	108	195	303	Quintana Roo
2020-08-09	244	394	638	99	190	289	Quintana Roo
2020-08-10	239	422	661	103	186	289	Quintana Roo
2020-08-11	237	459	696	102	195	297	Quintana Roo
2020-08-12	239	450	689	99	199	298	Quintana Roo
2020-08-13	232	442	674	100	207	307	Quintana Roo
2020-08-14	226	433	659	99	205	304	Quintana Roo
2020-08-15	219	393	612	102	192	294	Quintana Roo
2020-08-16	222	390	612	95	193	288	Quintana Roo
2020-08-17	210	405	615	97	189	286	Quintana Roo
2020-08-18	210	449	659	99	198	297	Quintana Roo
2020-08-19	205	449	654	98	198	296	Quintana Roo
2020-08-20	205	445	650	90	207	297	Quintana Roo
2020-08-21	186	454	640	95	210	305	Quintana Roo
2020-08-22	192	434	626	81	216	297	Quintana Roo
2020-08-23	183	400	583	74	205	279	Quintana Roo
2020-08-24	178	443	621	77	216	293	Quintana Roo
2020-08-25	164	460	624	76	215	291	Quintana Roo
2020-08-26	157	469	626	74	215	289	Quintana Roo
2020-08-27	149	459	608	64	219	283	Quintana Roo
2020-08-28	154	466	620	64	221	285	Quintana Roo
2020-08-29	169	475	644	63	220	283	Quintana Roo
2020-08-30	171	471	642	60	217	277	Quintana Roo
2020-08-31	168	467	635	62	218	280	Quintana Roo
2020-09-01	161	431	592	66	212	278	Quintana Roo
2020-09-02	155	464	619	68	216	284	Quintana Roo
2020-09-03	155	456	611	66	207	273	Quintana Roo
2020-09-04	140	464	604	68	208	276	Quintana Roo
2020-09-05	130	436	566	63	209	272	Quintana Roo
2020-09-06	136	462	598	59	207	266	Quintana Roo
2020-04-07	16	143	159	4	156	160	San Luis Potosí
2020-04-08	15	143	158	5	156	161	San Luis Potosí
2020-04-09	9	144	153	3	241	244	San Luis Potosí
2020-04-10	15	143	158	3	231	234	San Luis Potosí
2020-04-11	12	144	156	3	240	243	San Luis Potosí
2020-04-12	9	144	153	2	240	242	San Luis Potosí
2020-04-13	11	144	155	1	237	238	San Luis Potosí
2020-04-14	11	144	155	3	231	234	San Luis Potosí
2020-04-15	14	141	155	0	236	236	San Luis Potosí
2020-04-16	13	141	154	2	235	237	San Luis Potosí
2020-04-17	11	141	152	4	236	240	San Luis Potosí
2020-04-18	13	140	153	2	235	237	San Luis Potosí
2020-04-19	14	141	155	2	233	235	San Luis Potosí
2020-04-20	17	196	213	5	269	274	San Luis Potosí
2020-04-21	14	251	265	5	313	318	San Luis Potosí
2020-04-22	13	253	266	3	109	112	San Luis Potosí
2020-04-23	10	253	263	4	115	119	San Luis Potosí
2020-04-24	8	267	275	5	114	119	San Luis Potosí
2020-04-25	14	267	281	5	100	105	San Luis Potosí
2020-04-26	15	443	458	12	178	190	San Luis Potosí
2020-04-27	18	352	370	9	114	123	San Luis Potosí
2020-04-28	21	449	470	7	79	86	San Luis Potosí
2020-04-29	24	456	480	7	79	86	San Luis Potosí
2020-04-30	24	462	486	8	83	91	San Luis Potosí
2020-05-01	23	458	481	9	90	99	San Luis Potosí
2020-05-02	27	571	598	11	102	113	San Luis Potosí
2020-05-03	29	481	510	11	97	108	San Luis Potosí
2020-05-04	29	468	497	11	96	107	San Luis Potosí
2020-05-05	31	505	536	13	87	100	San Luis Potosí
2020-05-06	33	483	516	11	83	94	San Luis Potosí
2020-05-07	25	489	514	9	80	89	San Luis Potosí
2020-05-08	24	476	500	14	81	95	San Luis Potosí
2020-05-09	28	482	510	9	83	92	San Luis Potosí
2020-05-10	32	482	514	10	82	92	San Luis Potosí
2020-05-11	29	477	506	12	85	97	San Luis Potosí
2020-05-12	32	505	537	13	84	97	San Luis Potosí
2020-05-13	40	476	516	17	77	94	San Luis Potosí
2020-05-14	42	486	528	17	75	92	San Luis Potosí
2020-05-15	47	498	545	12	79	91	San Luis Potosí
2020-05-16	40	465	505	14	68	82	San Luis Potosí
2020-05-17	40	474	514	12	71	83	San Luis Potosí
2020-05-18	48	499	547	15	78	93	San Luis Potosí
2020-05-19	55	507	562	13	83	96	San Luis Potosí
2020-05-20	57	492	549	11	82	93	San Luis Potosí
2020-05-21	54	494	548	14	78	92	San Luis Potosí
2020-05-22	63	501	564	12	83	95	San Luis Potosí
2020-05-23	50	490	540	16	80	96	San Luis Potosí
2020-05-24	47	485	532	18	78	96	San Luis Potosí
2020-05-25	51	492	543	19	82	101	San Luis Potosí
2020-05-26	54	524	578	16	83	99	San Luis Potosí
2020-05-27	53	551	604	13	85	98	San Luis Potosí
2020-05-28	55	545	600	17	95	112	San Luis Potosí
2020-05-29	56	542	598	19	82	101	San Luis Potosí
2020-05-30	58	529	587	21	78	99	San Luis Potosí
2020-05-31	63	533	596	21	77	98	San Luis Potosí
2020-06-01	70	588	658	22	75	97	San Luis Potosí
2020-06-02	67	567	634	22	78	100	San Luis Potosí
2020-06-03	58	587	645	22	73	95	San Luis Potosí
2020-06-04	56	593	649	24	81	105	San Luis Potosí
2020-06-05	65	514	579	26	74	100	San Luis Potosí
2020-06-06	61	572	633	28	75	103	San Luis Potosí
2020-06-07	73	549	622	23	70	93	San Luis Potosí
2020-06-08	71	562	633	27	76	103	San Luis Potosí
2020-06-09	82	558	640	27	73	100	San Luis Potosí
2020-06-10	88	557	645	29	75	104	San Luis Potosí
2020-06-11	90	561	651	28	70	98	San Luis Potosí
2020-06-12	91	559	650	29	70	99	San Luis Potosí
2020-06-13	84	560	644	29	69	98	San Luis Potosí
2020-06-14	106	553	659	24	71	95	San Luis Potosí
2020-06-15	105	524	629	25	67	92	San Luis Potosí
2020-06-16	113	546	659	25	72	97	San Luis Potosí
2020-06-17	104	540	644	30	71	101	San Luis Potosí
2020-06-18	116	520	636	35	66	101	San Luis Potosí
2020-06-19	144	535	679	39	59	98	San Luis Potosí
2020-06-20	94	544	638	38	72	110	San Luis Potosí
2020-06-21	104	561	665	36	84	120	San Luis Potosí
2020-06-22	109	546	655	33	69	102	San Luis Potosí
2020-06-23	111	541	652	35	64	99	San Luis Potosí
2020-06-24	154	543	697	33	69	102	San Luis Potosí
2020-06-25	104	543	647	38	72	110	San Luis Potosí
2020-06-26	97	542	639	31	72	103	San Luis Potosí
2020-06-27	96	578	674	31	87	118	San Luis Potosí
2020-06-28	111	566	677	27	84	111	San Luis Potosí
2020-06-29	124	601	725	27	78	105	San Luis Potosí
2020-06-30	145	525	670	29	74	103	San Luis Potosí
2020-07-01	107	440	547	23	51	74	San Luis Potosí
2020-07-02	116	447	563	23	55	78	San Luis Potosí
2020-07-03	143	524	667	35	78	113	San Luis Potosí
2020-07-04	139	505	644	36	84	120	San Luis Potosí
2020-07-05	157	504	661	33	90	123	San Luis Potosí
2020-07-06	174	515	689	35	85	120	San Luis Potosí
2020-07-07	181	518	699	34	92	126	San Luis Potosí
2020-07-08	180	507	687	38	84	122	San Luis Potosí
2020-07-09	198	481	679	41	90	131	San Luis Potosí
2020-07-10	193	508	701	48	80	128	San Luis Potosí
2020-07-11	199	461	660	51	82	133	San Luis Potosí
2020-07-12	183	473	656	53	80	133	San Luis Potosí
2020-07-13	201	451	652	52	77	129	San Luis Potosí
2020-07-14	218	453	671	54	84	138	San Luis Potosí
2020-07-15	230	404	634	60	87	147	San Luis Potosí
2020-07-16	242	489	731	63	145	208	San Luis Potosí
2020-07-17	230	462	692	69	117	186	San Luis Potosí
2020-07-18	244	473	717	66	128	194	San Luis Potosí
2020-07-19	261	465	726	68	121	189	San Luis Potosí
2020-07-20	303	711	1,014	66	127	193	San Luis Potosí
2020-07-21	274	721	995	77	118	195	San Luis Potosí
2020-07-22	306	705	1,011	73	109	182	San Luis Potosí
2020-07-23	331	701	1,032	76	116	192	San Luis Potosí
2020-07-24	334	650	984	75	118	193	San Luis Potosí
2020-07-25	351	640	991	71	114	185	San Luis Potosí
2020-07-26	387	609	996	75	122	197	San Luis Potosí
2020-07-27	391	587	978	82	118	200	San Luis Potosí
2020-07-28	374	616	990	90	113	203	San Luis Potosí
2020-07-29	381	528	909	85	114	199	San Luis Potosí
2020-07-30	373	572	945	85	99	184	San Luis Potosí
2020-07-31	381	561	942	91	124	215	San Luis Potosí
2020-08-01	375	578	953	99	127	226	San Luis Potosí
2020-08-02	400	559	959	91	129	220	San Luis Potosí
2020-08-03	401	563	964	88	124	212	San Luis Potosí
2020-08-04	420	896	1,316	87	133	220	San Luis Potosí
2020-08-05	423	893	1,316	78	131	209	San Luis Potosí
2020-08-06	425	900	1,325	82	127	209	San Luis Potosí
2020-08-07	423	898	1,321	84	140	224	San Luis Potosí
2020-08-08	435	880	1,315	94	129	223	San Luis Potosí
2020-08-09	426	910	1,336	91	123	214	San Luis Potosí
2020-08-10	424	930	1,354	92	124	216	San Luis Potosí
2020-08-11	435	896	1,331	92	124	216	San Luis Potosí
2020-08-12	414	916	1,330	87	128	215	San Luis Potosí
2020-08-13	414	908	1,322	90	142	232	San Luis Potosí
2020-08-14	418	921	1,339	96	119	215	San Luis Potosí
2020-08-15	391	926	1,317	94	126	220	San Luis Potosí
2020-08-16	395	939	1,334	94	124	218	San Luis Potosí
2020-08-17	367	929	1,296	91	96	187	San Luis Potosí
2020-08-18	395	963	1,358	88	117	205	San Luis Potosí
2020-08-19	400	942	1,342	93	115	208	San Luis Potosí
2020-08-20	409	955	1,364	88	115	203	San Luis Potosí
2020-08-21	421	948	1,369	87	112	199	San Luis Potosí
2020-08-22	416	805	1,221	91	300	391	San Luis Potosí
2020-08-23	405	972	1,377	82	117	199	San Luis Potosí
2020-08-24	424	981	1,405	83	118	201	San Luis Potosí
2020-08-25	415	994	1,409	81	118	199	San Luis Potosí
2020-08-26	388	1013	1,401	76	120	196	San Luis Potosí
2020-08-27	379	1018	1,397	79	123	202	San Luis Potosí
2020-08-28	369	1015	1,384	79	124	203	San Luis Potosí
2020-08-29	375	1012	1,387	81	118	199	San Luis Potosí
2020-08-30	376	1015	1,391	80	123	203	San Luis Potosí
2020-08-31	366	1012	1,378	86	127	213	San Luis Potosí
2020-09-01	363	1024	1,387	79	122	201	San Luis Potosí
2020-09-02	330	1058	1,388	73	131	204	San Luis Potosí
2020-09-03	343	1052	1,395	73	132	205	San Luis Potosí
2020-09-04	318	1059	1,377	72	130	202	San Luis Potosí
2020-09-05	315	1074	1,389	59	133	192	San Luis Potosí
2020-09-06	324	1072	1,396	58	131	189	San Luis Potosí
2020-04-07	61	205	266	11	75	86	Sinaloa
2020-04-08	62	182	244	10	52	62	Sinaloa
2020-04-09	33	107	140	17	64	81	Sinaloa
2020-04-10	31	109	140	12	71	83	Sinaloa
2020-04-11	41	106	147	15	66	81	Sinaloa
2020-04-12	38	119	157	18	55	73	Sinaloa
2020-04-13	37	96	133	18	41	59	Sinaloa
2020-04-14	37	95	132	18	49	67	Sinaloa
2020-04-15	39	97	136	17	53	70	Sinaloa
2020-04-16	38	98	136	18	56	74	Sinaloa
2020-04-17	53	150	203	16	58	74	Sinaloa
2020-04-18	52	147	199	21	61	82	Sinaloa
2020-04-19	53	149	202	19	57	76	Sinaloa
2020-04-20	50	177	227	17	95	112	Sinaloa
2020-04-21	71	209	280	21	199	220	Sinaloa
2020-04-22	78	218	296	18	81	99	Sinaloa
2020-04-23	85	226	311	21	76	97	Sinaloa
2020-04-24	70	229	299	24	79	103	Sinaloa
2020-04-25	77	196	273	28	78	106	Sinaloa
2020-04-26	78	272	350	29	77	106	Sinaloa
2020-04-27	83	402	485	28	110	138	Sinaloa
2020-04-28	85	398	483	33	44	77	Sinaloa
2020-04-29	136	446	582	34	50	84	Sinaloa
2020-04-30	140	392	532	39	50	89	Sinaloa
2020-05-01	155	322	477	41	30	71	Sinaloa
2020-05-02	154	298	452	40	33	73	Sinaloa
2020-05-03	156	232	388	41	30	71	Sinaloa
2020-05-04	179	329	508	35	40	75	Sinaloa
2020-05-05	189	325	514	34	35	69	Sinaloa
2020-05-06	176	346	522	36	40	76	Sinaloa
2020-05-07	173	269	442	35	42	77	Sinaloa
2020-05-08	193	343	536	36	39	75	Sinaloa
2020-05-09	188	222	410	34	36	70	Sinaloa
2020-05-10	197	219	416	33	30	63	Sinaloa
2020-05-11	202	337	539	36	28	64	Sinaloa
2020-05-12	211	319	530	46	31	77	Sinaloa
2020-05-13	200	305	505	42	35	77	Sinaloa
2020-05-14	202	297	499	48	33	81	Sinaloa
2020-05-15	204	253	457	48	26	74	Sinaloa
2020-05-16	263	361	624	57	53	110	Sinaloa
2020-05-17	281	360	641	58	51	109	Sinaloa
2020-05-18	301	429	730	59	59	118	Sinaloa
2020-05-19	296	475	771	65	102	167	Sinaloa
2020-05-20	301	395	696	65	75	140	Sinaloa
2020-05-21	311	358	669	66	93	159	Sinaloa
2020-05-22	300	453	753	75	99	174	Sinaloa
2020-05-23	315	356	671	67	95	162	Sinaloa
2020-05-24	326	428	754	67	100	167	Sinaloa
2020-05-25	334	479	813	73	107	180	Sinaloa
2020-05-26	357	501	858	79	125	204	Sinaloa
2020-05-27	365	535	900	87	125	212	Sinaloa
2020-05-28	369	539	908	101	112	213	Sinaloa
2020-05-29	359	516	875	93	105	198	Sinaloa
2020-05-30	380	580	960	96	94	190	Sinaloa
2020-05-31	364	534	898	82	76	158	Sinaloa
2020-06-01	404	560	964	82	106	188	Sinaloa
2020-06-02	438	660	1,098	87	125	212	Sinaloa
2020-06-03	403	648	1,051	82	126	208	Sinaloa
2020-06-04	420	643	1,063	85	126	211	Sinaloa
2020-06-05	388	645	1,033	78	133	211	Sinaloa
2020-06-06	413	694	1,107	84	138	222	Sinaloa
2020-06-07	404	702	1,106	83	134	217	Sinaloa
2020-06-08	438	667	1,105	85	137	222	Sinaloa
2020-06-09	440	647	1,087	90	136	226	Sinaloa
2020-06-10	472	649	1,121	79	150	229	Sinaloa
2020-06-11	453	856	1,309	88	152	240	Sinaloa
2020-06-12	446	804	1,250	94	150	244	Sinaloa
2020-06-13	455	853	1,308	103	155	258	Sinaloa
2020-06-14	453	833	1,286	100	156	256	Sinaloa
2020-06-15	464	744	1,208	101	128	229	Sinaloa
2020-06-16	472	708	1,180	109	124	233	Sinaloa
2020-06-17	496	754	1,250	110	124	234	Sinaloa
2020-06-18	509	732	1,241	101	113	214	Sinaloa
2020-06-19	527	742	1,269	110	122	232	Sinaloa
2020-06-20	525	722	1,247	109	121	230	Sinaloa
2020-06-21	520	759	1,279	108	124	232	Sinaloa
2020-06-22	535	748	1,283	106	138	244	Sinaloa
2020-06-23	536	780	1,316	108	130	238	Sinaloa
2020-06-24	530	726	1,256	107	141	248	Sinaloa
2020-06-25	562	708	1,270	109	131	240	Sinaloa
2020-06-26	524	665	1,189	95	116	211	Sinaloa
2020-06-27	521	678	1,199	101	123	224	Sinaloa
2020-06-28	566	753	1,319	114	125	239	Sinaloa
2020-06-29	556	698	1,254	112	145	257	Sinaloa
2020-06-30	568	684	1,252	122	134	256	Sinaloa
2020-07-01	542	685	1,227	129	130	259	Sinaloa
2020-07-02	534	677	1,211	134	126	260	Sinaloa
2020-07-03	557	646	1,203	135	119	254	Sinaloa
2020-07-04	552	647	1,199	127	127	254	Sinaloa
2020-07-05	551	654	1,205	123	118	241	Sinaloa
2020-07-06	532	622	1,154	119	113	232	Sinaloa
2020-07-07	560	592	1,152	121	118	239	Sinaloa
2020-07-08	525	538	1,063	119	122	241	Sinaloa
2020-07-09	538	601	1,139	126	124	250	Sinaloa
2020-07-10	548	615	1,163	119	131	250	Sinaloa
2020-07-11	501	557	1,058	125	122	247	Sinaloa
2020-07-12	538	610	1,148	115	136	251	Sinaloa
2020-07-13	547	602	1,149	123	130	253	Sinaloa
2020-07-14	557	607	1,164	125	129	254	Sinaloa
2020-07-15	550	581	1,131	126	126	252	Sinaloa
2020-07-16	532	626	1,158	114	136	250	Sinaloa
2020-07-17	473	548	1,021	103	102	205	Sinaloa
2020-07-18	482	611	1,093	113	130	243	Sinaloa
2020-07-19	511	634	1,145	113	138	251	Sinaloa
2020-07-20	508	662	1,170	110	131	241	Sinaloa
2020-07-21	503	592	1,095	104	125	229	Sinaloa
2020-07-22	483	574	1,057	104	134	238	Sinaloa
2020-07-23	472	647	1,119	112	128	240	Sinaloa
2020-07-24	478	640	1,118	110	134	244	Sinaloa
2020-07-25	424	655	1,079	110	136	246	Sinaloa
2020-07-26	422	615	1,037	110	120	230	Sinaloa
2020-07-27	501	626	1,127	109	122	231	Sinaloa
2020-07-28	506	602	1,108	108	130	238	Sinaloa
2020-07-29	514	692	1,206	111	127	238	Sinaloa
2020-07-30	513	663	1,176	109	130	239	Sinaloa
2020-07-31	482	752	1,234	113	144	257	Sinaloa
2020-08-01	460	649	1,109	109	136	245	Sinaloa
2020-08-02	476	653	1,129	104	134	238	Sinaloa
2020-08-03	459	697	1,156	110	130	240	Sinaloa
2020-08-04	462	674	1,136	108	134	242	Sinaloa
2020-08-05	451	665	1,116	99	140	239	Sinaloa
2020-08-06	468	686	1,154	90	148	238	Sinaloa
2020-08-07	462	697	1,159	91	148	239	Sinaloa
2020-08-08	417	678	1,095	93	154	247	Sinaloa
2020-08-09	400	667	1,067	94	116	210	Sinaloa
2020-08-10	446	726	1,172	85	155	240	Sinaloa
2020-08-11	421	673	1,094	96	151	247	Sinaloa
2020-08-12	393	728	1,121	96	154	250	Sinaloa
2020-08-13	389	716	1,105	93	150	243	Sinaloa
2020-08-14	387	742	1,129	91	160	251	Sinaloa
2020-08-15	364	790	1,154	84	161	245	Sinaloa
2020-08-16	401	738	1,139	73	159	232	Sinaloa
2020-08-17	397	715	1,112	77	170	247	Sinaloa
2020-08-18	374	648	1,022	61	167	228	Sinaloa
2020-08-19	406	709	1,115	73	185	258	Sinaloa
2020-08-20	414	689	1,103	81	184	265	Sinaloa
2020-08-21	408	694	1,102	84	182	266	Sinaloa
2020-08-22	407	717	1,124	84	178	262	Sinaloa
2020-08-23	401	715	1,116	75	190	265	Sinaloa
2020-08-24	396	712	1,108	83	182	265	Sinaloa
2020-08-25	385	687	1,072	76	186	262	Sinaloa
2020-08-26	374	678	1,052	73	188	261	Sinaloa
2020-08-27	363	711	1,074	69	179	248	Sinaloa
2020-08-28	352	718	1,070	70	174	244	Sinaloa
2020-08-29	339	727	1,066	80	168	248	Sinaloa
2020-08-30	338	716	1,054	80	162	242	Sinaloa
2020-08-31	342	700	1,042	79	151	230	Sinaloa
2020-09-01	367	706	1,073	69	184	253	Sinaloa
2020-09-02	350	722	1,072	72	181	253	Sinaloa
2020-09-03	347	731	1,078	78	175	253	Sinaloa
2020-09-04	332	730	1,062	79	184	263	Sinaloa
2020-09-05	329	775	1,104	70	188	258	Sinaloa
2020-09-06	328	727	1,055	65	188	253	Sinaloa
2020-04-07	11	88	99	3	76	79	Sonora
2020-04-08	11	78	89	3	72	75	Sonora
2020-04-09	9	101	110	3	93	96	Sonora
2020-04-10	9	100	109	3	93	96	Sonora
2020-04-11	17	107	124	3	86	89	Sonora
2020-04-12	15	112	127	3	84	87	Sonora
2020-04-13	12	114	126	3	83	86	Sonora
2020-04-14	9	115	124	2	86	88	Sonora
2020-04-15	9	122	131	2	89	91	Sonora
2020-04-16	13	140	153	1	84	85	Sonora
2020-04-17	17	125	142	1	83	84	Sonora
2020-04-18	19	127	146	2	93	95	Sonora
2020-04-19	22	127	149	1	90	91	Sonora
2020-04-20	26	283	309	2	140	142	Sonora
2020-04-21	23	267	290	3	401	404	Sonora
2020-04-22	24	273	297	4	213	217	Sonora
2020-04-23	27	325	352	6	233	239	Sonora
2020-04-24	25	340	365	20	268	288	Sonora
2020-04-25	30	362	392	7	224	231	Sonora
2020-04-26	34	364	398	6	239	245	Sonora
2020-04-27	42	463	505	9	249	258	Sonora
2020-04-28	35	406	441	5	201	206	Sonora
2020-04-29	42	500	542	7	209	216	Sonora
2020-04-30	28	408	436	5	202	207	Sonora
2020-05-01	34	438	472	8	175	183	Sonora
2020-05-02	32	400	432	5	194	199	Sonora
2020-05-03	37	427	464	8	137	145	Sonora
2020-05-04	42	481	523	7	165	172	Sonora
2020-05-05	36	493	529	9	149	158	Sonora
2020-05-06	40	506	546	8	149	157	Sonora
2020-05-07	49	473	522	11	160	171	Sonora
2020-05-08	49	336	385	6	121	127	Sonora
2020-05-09	50	313	363	5	122	127	Sonora
2020-05-10	54	337	391	6	117	123	Sonora
2020-05-11	68	508	576	9	154	163	Sonora
2020-05-12	64	497	561	14	143	157	Sonora
2020-05-13	83	488	571	17	176	193	Sonora
2020-05-14	95	553	648	23	172	195	Sonora
2020-05-15	101	495	596	24	158	182	Sonora
2020-05-16	129	469	598	37	159	196	Sonora
2020-05-17	146	458	604	31	159	190	Sonora
2020-05-18	134	538	672	37	163	200	Sonora
2020-05-19	125	477	602	38	151	189	Sonora
2020-05-20	143	489	632	48	139	187	Sonora
2020-05-21	171	449	620	41	137	178	Sonora
2020-05-22	182	485	667	43	161	204	Sonora
2020-05-23	159	439	598	49	142	191	Sonora
2020-05-24	185	414	599	54	113	167	Sonora
2020-05-25	200	429	629	72	144	216	Sonora
2020-05-26	211	428	639	72	138	210	Sonora
2020-05-27	220	433	653	72	129	201	Sonora
2020-05-28	226	434	660	75	121	196	Sonora
2020-05-29	235	465	700	82	126	208	Sonora
2020-05-30	247	408	655	83	118	201	Sonora
2020-05-31	237	356	593	71	89	160	Sonora
2020-06-01	268	439	707	95	118	213	Sonora
2020-06-02	306	440	746	90	128	218	Sonora
2020-06-03	318	425	743	95	131	226	Sonora
2020-06-04	339	404	743	101	128	229	Sonora
2020-06-05	318	413	731	108	131	239	Sonora
2020-06-06	329	355	684	103	104	207	Sonora
2020-06-07	341	339	680	96	89	185	Sonora
2020-06-08	386	407	793	116	117	233	Sonora
2020-06-09	397	387	784	127	114	241	Sonora
2020-06-10	431	392	823	126	115	241	Sonora
2020-06-11	440	368	808	125	123	248	Sonora
2020-06-12	448	361	809	102	96	198	Sonora
2020-06-13	426	334	760	101	78	179	Sonora
2020-06-14	476	380	856	114	104	218	Sonora
2020-06-15	487	387	874	122	126	248	Sonora
2020-06-16	511	357	868	122	119	241	Sonora
2020-06-17	526	390	916	126	148	274	Sonora
2020-06-18	504	395	899	133	135	268	Sonora
2020-06-19	441	325	766	127	115	242	Sonora
2020-06-20	479	372	851	126	104	230	Sonora
2020-06-21	497	352	849	125	94	219	Sonora
2020-06-22	569	399	968	139	123	262	Sonora
2020-06-23	535	364	899	116	103	219	Sonora
2020-06-24	603	425	1,028	137	140	277	Sonora
2020-06-25	575	395	970	127	139	266	Sonora
2020-06-26	559	383	942	131	124	255	Sonora
2020-06-27	562	364	926	124	97	221	Sonora
2020-06-28	641	362	1,003	135	117	252	Sonora
2020-06-29	609	375	984	131	130	261	Sonora
2020-06-30	583	459	1,042	132	109	241	Sonora
2020-07-01	584	371	955	137	97	234	Sonora
2020-07-02	619	431	1,050	140	91	231	Sonora
2020-07-03	592	445	1,037	143	108	251	Sonora
2020-07-04	530	351	881	119	116	235	Sonora
2020-07-05	580	344	924	131	115	246	Sonora
2020-07-06	555	360	915	128	137	265	Sonora
2020-07-07	569	359	928	138	174	312	Sonora
2020-07-08	570	374	944	134	132	266	Sonora
2020-07-09	577	376	953	139	116	255	Sonora
2020-07-10	578	381	959	124	130	254	Sonora
2020-07-11	575	418	993	119	137	256	Sonora
2020-07-12	565	422	987	122	132	254	Sonora
2020-07-13	562	399	961	125	143	268	Sonora
2020-07-14	545	399	944	120	141	261	Sonora
2020-07-15	491	354	845	103	143	246	Sonora
2020-07-16	540	430	970	124	142	266	Sonora
2020-07-17	516	412	928	106	142	248	Sonora
2020-07-18	531	413	944	123	147	270	Sonora
2020-07-19	486	343	829	105	164	269	Sonora
2020-07-20	488	347	835	85	151	236	Sonora
2020-07-21	542	409	951	108	161	269	Sonora
2020-07-22	556	429	985	113	162	275	Sonora
2020-07-23	551	408	959	122	173	295	Sonora
2020-07-24	482	409	891	101	175	276	Sonora
2020-07-25	465	351	816	93	149	242	Sonora
2020-07-26	491	398	889	98	189	287	Sonora
2020-07-27	470	433	903	95	215	310	Sonora
2020-07-28	440	396	836	92	205	297	Sonora
2020-07-29	429	348	777	68	190	258	Sonora
2020-07-30	411	406	817	84	230	314	Sonora
2020-07-31	380	400	780	82	195	277	Sonora
2020-08-01	351	449	800	92	207	299	Sonora
2020-08-02	338	448	786	94	193	287	Sonora
2020-08-03	345	479	824	93	240	333	Sonora
2020-08-04	354	506	860	90	246	336	Sonora
2020-08-05	310	457	767	79	202	281	Sonora
2020-08-06	312	485	797	79	233	312	Sonora
2020-08-07	306	497	803	63	218	281	Sonora
2020-08-08	286	525	811	75	236	311	Sonora
2020-08-09	271	488	759	59	218	277	Sonora
2020-08-10	272	511	783	63	253	316	Sonora
2020-08-11	239	474	713	56	228	284	Sonora
2020-08-12	263	520	783	62	278	340	Sonora
2020-08-13	252	542	794	68	292	360	Sonora
2020-08-14	241	541	782	65	272	337	Sonora
2020-08-15	220	520	740	65	251	316	Sonora
2020-08-16	199	506	705	66	189	255	Sonora
2020-08-17	213	591	804	63	286	349	Sonora
2020-08-18	201	547	748	59	253	312	Sonora
2020-08-19	192	528	720	50	207	257	Sonora
2020-08-20	211	582	793	64	278	342	Sonora
2020-08-21	187	553	740	55	219	274	Sonora
2020-08-22	195	512	707	58	236	294	Sonora
2020-08-23	209	543	752	59	258	317	Sonora
2020-08-24	194	553	747	50	223	273	Sonora
2020-08-25	214	557	771	52	264	316	Sonora
2020-08-26	203	562	765	51	287	338	Sonora
2020-08-27	179	538	717	41	221	262	Sonora
2020-08-28	205	529	734	37	263	300	Sonora
2020-08-29	202	562	764	43	262	305	Sonora
2020-08-30	193	547	740	36	258	294	Sonora
2020-08-31	193	582	775	45	268	313	Sonora
2020-09-01	187	593	780	46	274	320	Sonora
2020-09-02	167	624	791	45	279	324	Sonora
2020-09-03	164	615	779	41	301	342	Sonora
2020-09-04	144	655	799	36	289	325	Sonora
2020-09-05	127	604	731	31	244	275	Sonora
2020-09-06	107	610	717	29	209	238	Sonora
2020-04-07	3	19	22	0	51	51	Tabasco
2020-04-08	3	17	20	0	45	45	Tabasco
2020-04-09	4	59	63	1	53	54	Tabasco
2020-04-10	5	58	63	0	49	49	Tabasco
2020-04-11	4	60	64	0	51	51	Tabasco
2020-04-12	3	61	64	1	38	39	Tabasco
2020-04-13	3	61	64	1	51	52	Tabasco
2020-04-14	6	61	67	1	48	49	Tabasco
2020-04-15	4	58	62	0	43	43	Tabasco
2020-04-16	10	64	74	0	49	49	Tabasco
2020-04-17	12	71	83	1	51	52	Tabasco
2020-04-18	60	262	322	12	120	132	Tabasco
2020-04-19	70	293	363	13	131	144	Tabasco
2020-04-20	59	315	374	12	115	127	Tabasco
2020-04-21	63	313	376	17	127	144	Tabasco
2020-04-22	64	289	353	19	128	147	Tabasco
2020-04-23	77	312	389	22	146	168	Tabasco
2020-04-24	81	305	386	18	145	163	Tabasco
2020-04-25	86	307	393	20	141	161	Tabasco
2020-04-26	87	374	461	24	151	175	Tabasco
2020-04-27	105	421	526	29	144	173	Tabasco
2020-04-28	120	419	539	43	117	160	Tabasco
2020-04-29	154	443	597	43	123	166	Tabasco
2020-04-30	161	362	523	42	112	154	Tabasco
2020-05-01	164	380	544	44	118	162	Tabasco
2020-05-02	138	336	474	60	116	176	Tabasco
2020-05-03	171	309	480	38	131	169	Tabasco
2020-05-04	144	335	479	63	135	198	Tabasco
2020-05-05	167	370	537	44	138	182	Tabasco
2020-05-06	200	355	555	47	143	190	Tabasco
2020-05-07	209	362	571	49	143	192	Tabasco
2020-05-08	192	358	550	45	138	183	Tabasco
2020-05-09	214	371	585	45	138	183	Tabasco
2020-05-10	201	411	612	48	148	196	Tabasco
2020-05-11	230	350	580	47	147	194	Tabasco
2020-05-12	251	449	700	48	156	204	Tabasco
2020-05-13	259	406	665	50	159	209	Tabasco
2020-05-14	283	410	693	53	153	206	Tabasco
2020-05-15	295	380	675	56	155	211	Tabasco
2020-05-16	285	383	668	51	156	207	Tabasco
2020-05-17	278	385	663	52	147	199	Tabasco
2020-05-18	269	344	613	67	129	196	Tabasco
2020-05-19	253	385	638	73	129	202	Tabasco
2020-05-20	250	334	584	71	129	200	Tabasco
2020-05-21	275	405	680	64	149	213	Tabasco
2020-05-22	253	412	665	80	145	225	Tabasco
2020-05-23	252	408	660	74	148	222	Tabasco
2020-05-24	259	384	643	70	136	206	Tabasco
2020-05-25	262	397	659	53	146	199	Tabasco
2020-05-26	286	432	718	57	157	214	Tabasco
2020-05-27	284	425	709	65	151	216	Tabasco
2020-05-28	263	210	473	45	101	146	Tabasco
2020-05-29	250	202	452	48	98	146	Tabasco
2020-05-30	264	286	550	68	117	185	Tabasco
2020-05-31	268	221	489	63	115	178	Tabasco
2020-06-01	248	239	487	61	126	187	Tabasco
2020-06-02	237	320	557	79	134	213	Tabasco
2020-06-03	233	251	484	81	104	185	Tabasco
2020-06-04	202	242	444	77	101	178	Tabasco
2020-06-05	183	245	428	78	101	179	Tabasco
2020-06-06	225	333	558	92	117	209	Tabasco
2020-06-07	193	267	460	73	103	176	Tabasco
2020-06-08	253	281	534	73	131	204	Tabasco
2020-06-09	265	272	537	78	126	204	Tabasco
2020-06-10	242	288	530	80	122	202	Tabasco
2020-06-11	252	311	563	82	119	201	Tabasco
2020-06-12	267	279	546	86	101	187	Tabasco
2020-06-13	222	237	459	68	98	166	Tabasco
2020-06-14	270	274	544	89	107	196	Tabasco
2020-06-15	250	271	521	92	94	186	Tabasco
2020-06-16	271	291	562	86	116	202	Tabasco
2020-06-17	245	255	500	67	104	171	Tabasco
2020-06-18	247	221	468	72	100	172	Tabasco
2020-06-19	292	290	582	96	106	202	Tabasco
2020-06-20	304	294	598	96	114	210	Tabasco
2020-06-21	304	276	580	100	96	196	Tabasco
2020-06-22	315	256	571	94	105	199	Tabasco
2020-06-23	295	282	577	92	120	212	Tabasco
2020-06-24	310	273	583	94	109	203	Tabasco
2020-06-25	344	257	601	98	108	206	Tabasco
2020-06-26	343	237	580	101	109	210	Tabasco
2020-06-27	360	229	589	104	94	198	Tabasco
2020-06-28	371	219	590	99	93	192	Tabasco
2020-06-29	377	216	593	93	112	205	Tabasco
2020-06-30	398	190	588	94	111	205	Tabasco
2020-07-01	419	181	600	102	112	214	Tabasco
2020-07-02	424	173	597	106	112	218	Tabasco
2020-07-03	376	95	471	82	74	156	Tabasco
2020-07-04	473	143	616	103	101	204	Tabasco
2020-07-05	474	145	619	113	98	211	Tabasco
2020-07-06	490	142	632	107	98	205	Tabasco
2020-07-07	481	76	557	98	69	167	Tabasco
2020-07-08	516	97	613	95	96	191	Tabasco
2020-07-09	500	119	619	105	82	187	Tabasco
2020-07-10	515	99	614	90	100	190	Tabasco
2020-07-11	520	117	637	108	74	182	Tabasco
2020-07-12	505	127	632	111	83	194	Tabasco
2020-07-13	502	130	632	114	73	187	Tabasco
2020-07-14	476	115	591	113	80	193	Tabasco
2020-07-15	444	86	530	105	72	177	Tabasco
2020-07-16	506	89	595	126	69	195	Tabasco
2020-07-17	484	110	594	118	76	194	Tabasco
2020-07-18	473	134	607	125	69	194	Tabasco
2020-07-19	502	160	662	133	69	202	Tabasco
2020-07-20	517	144	661	131	68	199	Tabasco
2020-07-21	519	142	661	137	62	199	Tabasco
2020-07-22	519	145	664	129	68	197	Tabasco
2020-07-23	531	161	692	132	71	203	Tabasco
2020-07-24	544	153	697	137	84	221	Tabasco
2020-07-25	536	160	696	134	69	203	Tabasco
2020-07-26	541	153	694	142	65	207	Tabasco
2020-07-27	516	174	690	142	64	206	Tabasco
2020-07-28	522	168	690	142	68	210	Tabasco
2020-07-29	494	188	682	143	86	229	Tabasco
2020-07-30	514	188	702	142	84	226	Tabasco
2020-07-31	447	237	684	120	85	205	Tabasco
2020-08-01	490	270	760	130	97	227	Tabasco
2020-08-02	486	276	762	132	97	229	Tabasco
2020-08-03	484	281	765	120	105	225	Tabasco
2020-08-04	477	273	750	123	106	229	Tabasco
2020-08-05	459	315	774	116	101	217	Tabasco
2020-08-06	396	299	695	103	97	200	Tabasco
2020-08-07	429	339	768	114	114	228	Tabasco
2020-08-08	369	301	670	96	105	201	Tabasco
2020-08-09	396	338	734	112	104	216	Tabasco
2020-08-10	367	395	762	106	116	222	Tabasco
2020-08-11	370	396	766	103	124	227	Tabasco
2020-08-12	364	395	759	107	121	228	Tabasco
2020-08-13	332	415	747	88	137	225	Tabasco
2020-08-14	336	437	773	88	138	226	Tabasco
2020-08-15	334	434	768	86	138	224	Tabasco
2020-08-16	301	470	771	82	145	227	Tabasco
2020-08-17	274	499	773	75	148	223	Tabasco
2020-08-18	284	484	768	77	162	239	Tabasco
2020-08-19	249	461	710	72	155	227	Tabasco
2020-08-20	277	491	768	72	166	238	Tabasco
2020-08-21	287	497	784	72	160	232	Tabasco
2020-08-22	193	456	649	48	111	159	Tabasco
2020-08-23	253	551	804	69	166	235	Tabasco
2020-08-24	242	556	798	68	169	237	Tabasco
2020-08-25	248	552	800	67	170	237	Tabasco
2020-08-26	217	584	801	68	168	236	Tabasco
2020-08-27	217	587	804	54	177	231	Tabasco
2020-08-28	205	594	799	62	185	247	Tabasco
2020-08-29	210	569	779	52	177	229	Tabasco
2020-08-30	192	607	799	67	174	241	Tabasco
2020-08-31	171	627	798	70	165	235	Tabasco
2020-09-01	184	617	801	61	177	238	Tabasco
2020-09-02	183	593	776	56	173	229	Tabasco
2020-09-03	176	569	745	55	172	227	Tabasco
2020-09-04	176	516	692	44	174	218	Tabasco
2020-09-05	187	606	793	55	174	229	Tabasco
2020-09-06	184	577	761	51	174	225	Tabasco
2020-04-07	3	44	47	0	70	70	Tamaulipas
2020-04-08	3	45	48	0	69	69	Tamaulipas
2020-04-09	4	67	71	0	64	64	Tamaulipas
2020-04-10	4	67	71	1	62	63	Tamaulipas
2020-04-11	5	74	79	1	63	64	Tamaulipas
2020-04-12	7	74	81	1	60	61	Tamaulipas
2020-04-13	8	74	82	1	60	61	Tamaulipas
2020-04-14	6	74	80	2	59	61	Tamaulipas
2020-04-15	7	74	81	2	55	57	Tamaulipas
2020-04-16	5	74	79	3	52	55	Tamaulipas
2020-04-17	4	74	78	3	53	56	Tamaulipas
2020-04-18	6	72	78	4	50	54	Tamaulipas
2020-04-19	7	84	91	4	67	71	Tamaulipas
2020-04-20	12	121	133	5	84	89	Tamaulipas
2020-04-21	12	254	266	6	410	416	Tamaulipas
2020-04-22	16	283	299	7	181	188	Tamaulipas
2020-04-23	16	338	354	9	208	217	Tamaulipas
2020-04-24	12	339	351	7	216	223	Tamaulipas
2020-04-25	19	315	334	5	197	202	Tamaulipas
2020-04-26	22	357	379	6	208	214	Tamaulipas
2020-04-27	38	418	456	7	225	232	Tamaulipas
2020-04-28	30	425	455	5	178	183	Tamaulipas
2020-04-29	48	437	485	9	166	175	Tamaulipas
2020-04-30	54	439	493	7	162	169	Tamaulipas
2020-05-01	50	367	417	5	178	183	Tamaulipas
2020-05-02	52	488	540	7	177	184	Tamaulipas
2020-05-03	46	496	542	9	175	184	Tamaulipas
2020-05-04	54	459	513	9	184	193	Tamaulipas
2020-05-05	42	470	512	14	163	177	Tamaulipas
2020-05-06	61	534	595	14	199	213	Tamaulipas
2020-05-07	61	497	558	13	206	219	Tamaulipas
2020-05-08	69	569	638	12	211	223	Tamaulipas
2020-05-09	55	544	599	13	194	207	Tamaulipas
2020-05-10	44	518	562	13	170	183	Tamaulipas
2020-05-11	67	585	652	10	195	205	Tamaulipas
2020-05-12	77	633	710	13	199	212	Tamaulipas
2020-05-13	81	624	705	11	202	213	Tamaulipas
2020-05-14	85	594	679	12	196	208	Tamaulipas
2020-05-15	83	592	675	13	180	193	Tamaulipas
2020-05-16	82	558	640	14	158	172	Tamaulipas
2020-05-17	74	607	681	17	161	178	Tamaulipas
2020-05-18	80	551	631	17	167	184	Tamaulipas
2020-05-19	88	595	683	21	169	190	Tamaulipas
2020-05-20	80	618	698	25	166	191	Tamaulipas
2020-05-21	93	622	715	29	168	197	Tamaulipas
2020-05-22	90	638	728	24	168	192	Tamaulipas
2020-05-23	93	502	595	24	131	155	Tamaulipas
2020-05-24	91	547	638	33	150	183	Tamaulipas
2020-05-25	94	624	718	34	173	207	Tamaulipas
2020-05-26	95	600	695	30	167	197	Tamaulipas
2020-05-27	109	666	775	34	172	206	Tamaulipas
2020-05-28	91	647	738	36	173	209	Tamaulipas
2020-05-29	99	685	784	32	183	215	Tamaulipas
2020-05-30	83	594	677	27	161	188	Tamaulipas
2020-05-31	76	567	643	22	139	161	Tamaulipas
2020-06-01	86	608	694	22	165	187	Tamaulipas
2020-06-02	108	781	889	27	176	203	Tamaulipas
2020-06-03	117	776	893	28	161	189	Tamaulipas
2020-06-04	108	744	852	36	173	209	Tamaulipas
2020-06-05	106	773	879	42	165	207	Tamaulipas
2020-06-06	96	756	852	44	146	190	Tamaulipas
2020-06-07	107	752	859	44	148	192	Tamaulipas
2020-06-08	111	812	923	47	166	213	Tamaulipas
2020-06-09	119	724	843	41	172	213	Tamaulipas
2020-06-10	117	735	852	46	173	219	Tamaulipas
2020-06-11	121	656	777	44	166	210	Tamaulipas
2020-06-12	115	681	796	55	168	223	Tamaulipas
2020-06-13	126	645	771	49	156	205	Tamaulipas
2020-06-14	149	621	770	53	145	198	Tamaulipas
2020-06-15	162	673	835	53	165	218	Tamaulipas
2020-06-16	179	640	819	51	159	210	Tamaulipas
2020-06-17	184	598	782	46	166	212	Tamaulipas
2020-06-18	178	621	799	47	174	221	Tamaulipas
2020-06-19	208	625	833	55	155	210	Tamaulipas
2020-06-20	233	600	833	53	148	201	Tamaulipas
2020-06-21	254	621	875	53	142	195	Tamaulipas
2020-06-22	269	649	918	59	176	235	Tamaulipas
2020-06-23	303	659	962	57	179	236	Tamaulipas
2020-06-24	310	674	984	60	178	238	Tamaulipas
2020-06-25	323	661	984	68	168	236	Tamaulipas
2020-06-26	348	666	1,014	74	157	231	Tamaulipas
2020-06-27	330	616	946	77	141	218	Tamaulipas
2020-06-28	343	620	963	70	133	203	Tamaulipas
2020-06-29	382	637	1,019	81	151	232	Tamaulipas
2020-06-30	405	664	1,069	83	173	256	Tamaulipas
2020-07-01	432	727	1,159	85	167	252	Tamaulipas
2020-07-02	430	680	1,110	83	167	250	Tamaulipas
2020-07-03	460	667	1,127	94	155	249	Tamaulipas
2020-07-04	432	598	1,030	79	136	215	Tamaulipas
2020-07-05	506	660	1,166	95	168	263	Tamaulipas
2020-07-06	511	650	1,161	91	156	247	Tamaulipas
2020-07-07	537	655	1,192	74	157	231	Tamaulipas
2020-07-08	531	668	1,199	83	185	268	Tamaulipas
2020-07-09	581	632	1,213	92	196	288	Tamaulipas
2020-07-10	588	624	1,212	93	148	241	Tamaulipas
2020-07-11	563	628	1,191	96	149	245	Tamaulipas
2020-07-12	501	590	1,091	77	146	223	Tamaulipas
2020-07-13	577	598	1,175	98	185	283	Tamaulipas
2020-07-14	624	591	1,215	101	163	264	Tamaulipas
2020-07-15	644	604	1,248	101	184	285	Tamaulipas
2020-07-16	660	553	1,213	112	177	289	Tamaulipas
2020-07-17	665	533	1,198	110	171	281	Tamaulipas
2020-07-18	688	427	1,115	110	162	272	Tamaulipas
2020-07-19	694	427	1,121	104	128	232	Tamaulipas
2020-07-20	738	530	1,268	116	151	267	Tamaulipas
2020-07-21	782	526	1,308	118	156	274	Tamaulipas
2020-07-22	737	491	1,228	111	174	285	Tamaulipas
2020-07-23	700	533	1,233	104	173	277	Tamaulipas
2020-07-24	686	527	1,213	93	187	280	Tamaulipas
2020-07-25	670	545	1,215	92	169	261	Tamaulipas
2020-07-26	717	553	1,270	92	173	265	Tamaulipas
2020-07-27	669	493	1,162	93	175	268	Tamaulipas
2020-07-28	623	561	1,184	79	187	266	Tamaulipas
2020-07-29	643	531	1,174	84	167	251	Tamaulipas
2020-07-30	680	624	1,304	101	189	290	Tamaulipas
2020-07-31	652	610	1,262	89	189	278	Tamaulipas
2020-08-01	624	608	1,232	92	179	271	Tamaulipas
2020-08-02	656	615	1,271	94	177	271	Tamaulipas
2020-08-03	676	614	1,290	96	187	283	Tamaulipas
2020-08-04	694	624	1,318	105	185	290	Tamaulipas
2020-08-05	620	592	1,212	105	188	293	Tamaulipas
2020-08-06	614	672	1,286	110	198	308	Tamaulipas
2020-08-07	596	664	1,260	112	200	312	Tamaulipas
2020-08-08	520	669	1,189	89	181	270	Tamaulipas
2020-08-09	601	729	1,330	99	183	282	Tamaulipas
2020-08-10	605	735	1,340	113	192	305	Tamaulipas
2020-08-11	597	724	1,321	111	192	303	Tamaulipas
2020-08-12	609	815	1,424	108	197	305	Tamaulipas
2020-08-13	592	876	1,468	110	180	290	Tamaulipas
2020-08-14	535	897	1,432	106	165	271	Tamaulipas
2020-08-15	587	897	1,484	91	171	262	Tamaulipas
2020-08-16	565	885	1,450	89	179	268	Tamaulipas
2020-08-17	572	904	1,476	104	194	298	Tamaulipas
2020-08-18	540	753	1,293	98	177	275	Tamaulipas
2020-08-19	552	796	1,348	100	189	289	Tamaulipas
2020-08-20	529	777	1,306	114	182	296	Tamaulipas
2020-08-21	504	817	1,321	113	189	302	Tamaulipas
2020-08-22	472	741	1,213	82	164	246	Tamaulipas
2020-08-23	502	809	1,311	88	192	280	Tamaulipas
2020-08-24	484	813	1,297	91	208	299	Tamaulipas
2020-08-25	500	840	1,340	80	216	296	Tamaulipas
2020-08-26	472	845	1,317	84	212	296	Tamaulipas
2020-08-27	428	880	1,308	80	209	289	Tamaulipas
2020-08-28	452	873	1,325	76	222	298	Tamaulipas
2020-08-29	435	877	1,312	70	208	278	Tamaulipas
2020-08-30	439	844	1,283	62	176	238	Tamaulipas
2020-08-31	467	918	1,385	75	227	302	Tamaulipas
2020-09-01	458	910	1,368	77	220	297	Tamaulipas
2020-09-02	452	894	1,346	73	223	296	Tamaulipas
2020-09-03	383	783	1,166	68	165	233	Tamaulipas
2020-09-04	369	832	1,201	81	200	281	Tamaulipas
2020-09-05	429	930	1,359	66	216	282	Tamaulipas
2020-09-06	397	828	1,225	63	186	249	Tamaulipas
2020-04-07	5	32	37	1	28	29	Tlaxcala
2020-04-08	5	32	37	1	28	29	Tlaxcala
2020-04-09	7	32	39	1	25	26	Tlaxcala
2020-04-10	6	32	38	1	25	26	Tlaxcala
2020-04-11	4	107	111	1	31	32	Tlaxcala
2020-04-12	5	107	112	2	28	30	Tlaxcala
2020-04-13	3	105	108	2	37	39	Tlaxcala
2020-04-14	6	107	113	3	39	42	Tlaxcala
2020-04-15	3	111	114	4	43	47	Tlaxcala
2020-04-16	4	24	28	3	28	31	Tlaxcala
2020-04-17	5	23	28	3	28	31	Tlaxcala
2020-04-18	4	16	20	3	35	38	Tlaxcala
2020-04-19	5	16	21	2	31	33	Tlaxcala
2020-04-20	8	35	43	1	27	28	Tlaxcala
2020-04-21	6	49	55	3	115	118	Tlaxcala
2020-04-22	9	77	86	4	38	42	Tlaxcala
2020-04-23	12	75	87	5	41	46	Tlaxcala
2020-04-24	12	109	121	5	41	46	Tlaxcala
2020-04-25	9	113	122	6	38	44	Tlaxcala
2020-04-26	7	115	122	7	38	45	Tlaxcala
2020-04-27	7	88	95	7	44	51	Tlaxcala
2020-04-28	7	108	115	5	18	23	Tlaxcala
2020-04-29	18	108	126	5	23	28	Tlaxcala
2020-04-30	23	107	130	3	23	26	Tlaxcala
2020-05-01	27	108	135	4	21	25	Tlaxcala
2020-05-02	27	111	138	6	14	20	Tlaxcala
2020-05-03	34	112	146	7	17	24	Tlaxcala
2020-05-04	35	112	147	7	24	31	Tlaxcala
2020-05-05	26	115	141	9	23	32	Tlaxcala
2020-05-06	22	136	158	8	36	44	Tlaxcala
2020-05-07	27	132	159	7	37	44	Tlaxcala
2020-05-08	27	131	158	10	36	46	Tlaxcala
2020-05-09	27	130	157	10	36	46	Tlaxcala
2020-05-10	27	128	155	9	27	36	Tlaxcala
2020-05-11	27	120	147	10	32	42	Tlaxcala
2020-05-12	31	118	149	12	30	42	Tlaxcala
2020-05-13	34	119	153	12	29	41	Tlaxcala
2020-05-14	42	113	155	11	28	39	Tlaxcala
2020-05-15	42	114	156	12	27	39	Tlaxcala
2020-05-16	29	116	145	12	22	34	Tlaxcala
2020-05-17	35	115	150	10	25	35	Tlaxcala
2020-05-18	31	119	150	9	31	40	Tlaxcala
2020-05-19	38	118	156	10	29	39	Tlaxcala
2020-05-20	38	117	155	10	30	40	Tlaxcala
2020-05-21	44	115	159	14	29	43	Tlaxcala
2020-05-22	47	113	160	13	21	34	Tlaxcala
2020-05-23	43	113	156	15	22	37	Tlaxcala
2020-05-24	45	114	159	12	27	39	Tlaxcala
2020-05-25	44	117	161	13	28	41	Tlaxcala
2020-05-26	44	123	167	30	34	64	Tlaxcala
2020-05-27	59	133	192	19	34	53	Tlaxcala
2020-05-28	60	108	168	20	45	65	Tlaxcala
2020-05-29	53	83	136	27	54	81	Tlaxcala
2020-05-30	56	82	138	32	46	78	Tlaxcala
2020-05-31	60	71	131	37	41	78	Tlaxcala
2020-06-01	71	64	135	26	38	64	Tlaxcala
2020-06-02	65	58	123	24	40	64	Tlaxcala
2020-06-03	67	88	155	22	48	70	Tlaxcala
2020-06-04	54	91	145	35	50	85	Tlaxcala
2020-06-05	65	79	144	33	51	84	Tlaxcala
2020-06-06	68	78	146	39	41	80	Tlaxcala
2020-06-07	79	76	155	33	45	78	Tlaxcala
2020-06-08	88	72	160	36	41	77	Tlaxcala
2020-06-09	72	84	156	35	45	80	Tlaxcala
2020-06-10	81	79	160	34	45	79	Tlaxcala
2020-06-11	76	83	159	31	49	80	Tlaxcala
2020-06-12	81	63	144	30	47	77	Tlaxcala
2020-06-13	86	45	131	21	44	65	Tlaxcala
2020-06-14	83	74	157	29	50	79	Tlaxcala
2020-06-15	90	86	176	40	40	80	Tlaxcala
2020-06-16	91	86	177	37	43	80	Tlaxcala
2020-06-17	101	71	172	40	37	77	Tlaxcala
2020-06-18	93	71	164	49	27	76	Tlaxcala
2020-06-19	94	83	177	50	33	83	Tlaxcala
2020-06-20	118	89	207	55	57	112	Tlaxcala
2020-06-21	122	83	205	54	58	112	Tlaxcala
2020-06-22	123	94	217	45	78	123	Tlaxcala
2020-06-23	137	120	257	45	76	121	Tlaxcala
2020-06-24	120	129	249	47	76	123	Tlaxcala
2020-06-25	118	136	254	57	68	125	Tlaxcala
2020-06-26	116	170	286	62	62	124	Tlaxcala
2020-06-27	123	166	289	61	65	126	Tlaxcala
2020-06-28	133	167	300	51	77	128	Tlaxcala
2020-06-29	139	184	323	51	77	128	Tlaxcala
2020-06-30	128	158	286	51	77	128	Tlaxcala
2020-07-01	120	199	319	52	71	123	Tlaxcala
2020-07-02	130	182	312	54	77	131	Tlaxcala
2020-07-03	150	170	320	52	79	131	Tlaxcala
2020-07-04	143	170	313	52	78	130	Tlaxcala
2020-07-05	144	164	308	50	80	130	Tlaxcala
2020-07-06	145	170	315	56	73	129	Tlaxcala
2020-07-07	135	178	313	58	72	130	Tlaxcala
2020-07-08	129	175	304	52	74	126	Tlaxcala
2020-07-09	135	171	306	52	73	125	Tlaxcala
2020-07-10	126	143	269	59	65	124	Tlaxcala
2020-07-11	148	134	282	57	67	124	Tlaxcala
2020-07-12	129	142	271	53	72	125	Tlaxcala
2020-07-13	141	137	278	53	70	123	Tlaxcala
2020-07-14	143	136	279	54	71	125	Tlaxcala
2020-07-15	123	148	271	60	70	130	Tlaxcala
2020-07-16	123	154	277	58	72	130	Tlaxcala
2020-07-17	119	158	277	58	73	131	Tlaxcala
2020-07-18	126	143	269	56	76	132	Tlaxcala
2020-07-19	123	139	262	56	80	136	Tlaxcala
2020-07-20	127	139	266	50	85	135	Tlaxcala
2020-07-21	129	141	270	54	74	128	Tlaxcala
2020-07-22	115	155	270	58	84	142	Tlaxcala
2020-07-23	114	163	277	57	78	135	Tlaxcala
2020-07-24	109	179	288	52	80	132	Tlaxcala
2020-07-25	106	169	275	46	71	117	Tlaxcala
2020-07-26	101	158	259	55	77	132	Tlaxcala
2020-07-27	102	174	276	54	71	125	Tlaxcala
2020-07-28	106	171	277	56	81	137	Tlaxcala
2020-07-29	107	173	280	53	76	129	Tlaxcala
2020-07-30	117	330	447	60	75	135	Tlaxcala
2020-07-31	107	338	445	63	73	136	Tlaxcala
2020-08-01	117	323	440	63	65	128	Tlaxcala
2020-08-02	116	314	430	61	71	132	Tlaxcala
2020-08-03	118	324	442	65	67	132	Tlaxcala
2020-08-04	121	321	442	62	65	127	Tlaxcala
2020-08-05	120	315	435	61	71	132	Tlaxcala
2020-08-06	122	325	447	56	75	131	Tlaxcala
2020-08-07	110	324	434	54	67	121	Tlaxcala
2020-08-08	107	334	441	55	74	129	Tlaxcala
2020-08-09	97	341	438	58	72	130	Tlaxcala
2020-08-10	84	361	445	62	69	131	Tlaxcala
2020-08-11	89	352	441	58	70	128	Tlaxcala
2020-08-12	84	364	448	56	74	130	Tlaxcala
2020-08-13	78	369	447	53	76	129	Tlaxcala
2020-08-14	82	362	444	52	79	131	Tlaxcala
2020-08-15	69	359	428	56	75	131	Tlaxcala
2020-08-16	71	359	430	54	76	130	Tlaxcala
2020-08-17	78	364	442	54	77	131	Tlaxcala
2020-08-18	71	366	437	56	77	133	Tlaxcala
2020-08-19	76	363	439	54	80	134	Tlaxcala
2020-08-20	74	370	444	56	80	136	Tlaxcala
2020-08-21	68	378	446	51	82	133	Tlaxcala
2020-08-22	60	373	433	51	81	132	Tlaxcala
2020-08-23	66	370	436	47	88	135	Tlaxcala
2020-08-24	66	376	442	47	86	133	Tlaxcala
2020-08-25	69	369	438	47	88	135	Tlaxcala
2020-08-26	80	363	443	43	90	133	Tlaxcala
2020-08-27	77	359	436	39	94	133	Tlaxcala
2020-08-28	85	351	436	37	95	132	Tlaxcala
2020-08-29	50	380	430	36	97	133	Tlaxcala
2020-08-30	52	377	429	33	101	134	Tlaxcala
2020-08-31	51	385	436	36	96	132	Tlaxcala
2020-09-01	49	388	437	36	97	133	Tlaxcala
2020-09-02	57	393	450	25	108	133	Tlaxcala
2020-09-03	52	389	441	28	103	131	Tlaxcala
2020-09-04	51	390	441	29	104	133	Tlaxcala
2020-09-05	51	369	420	25	103	128	Tlaxcala
2020-09-06	52	369	421	29	99	128	Tlaxcala
2020-04-07	18	112	130	5	121	126	Veracruz
2020-04-08	19	148	167	3	165	168	Veracruz
2020-04-09	15	174	189	4	117	121	Veracruz
2020-04-10	20	182	202	5	108	113	Veracruz
2020-04-11	25	187	212	3	106	109	Veracruz
2020-04-12	22	223	245	7	104	111	Veracruz
2020-04-13	19	229	248	6	103	109	Veracruz
2020-04-14	22	224	246	7	130	137	Veracruz
2020-04-15	21	240	261	7	124	131	Veracruz
2020-04-16	33	220	253	8	134	142	Veracruz
2020-04-17	29	216	245	11	124	135	Veracruz
2020-04-18	27	211	238	8	194	202	Veracruz
2020-04-19	24	233	257	8	192	200	Veracruz
2020-04-20	41	305	346	11	238	249	Veracruz
2020-04-21	52	484	536	11	363	374	Veracruz
2020-04-22	67	494	561	16	269	285	Veracruz
2020-04-23	70	460	530	17	259	276	Veracruz
2020-04-24	78	522	600	24	264	288	Veracruz
2020-04-25	78	451	529	28	262	290	Veracruz
2020-04-26	80	573	653	26	265	291	Veracruz
2020-04-27	93	620	713	37	291	328	Veracruz
2020-04-28	94	594	688	41	195	236	Veracruz
2020-04-29	140	671	811	45	192	237	Veracruz
2020-04-30	169	647	816	60	208	268	Veracruz
2020-05-01	168	656	824	54	186	240	Veracruz
2020-05-02	193	682	875	53	170	223	Veracruz
2020-05-03	245	673	918	52	163	215	Veracruz
2020-05-04	319	683	1,002	64	186	250	Veracruz
2020-05-05	326	635	961	52	162	214	Veracruz
2020-05-06	340	639	979	62	191	253	Veracruz
2020-05-07	335	620	955	74	193	267	Veracruz
2020-05-08	359	633	992	81	185	266	Veracruz
2020-05-09	339	604	943	78	178	256	Veracruz
2020-05-10	341	600	941	76	195	271	Veracruz
2020-05-11	375	600	975	79	213	292	Veracruz
2020-05-12	409	613	1,022	78	193	271	Veracruz
2020-05-13	400	605	1,005	90	197	287	Veracruz
2020-05-14	422	596	1,018	90	205	295	Veracruz
2020-05-15	416	620	1,036	97	203	300	Veracruz
2020-05-16	402	596	998	72	182	254	Veracruz
2020-05-17	474	570	1,044	88	167	255	Veracruz
2020-05-18	488	558	1,046	104	182	286	Veracruz
2020-05-19	460	584	1,044	104	204	308	Veracruz
2020-05-20	481	594	1,075	116	183	299	Veracruz
2020-05-21	480	622	1,102	125	217	342	Veracruz
2020-05-22	484	608	1,092	130	187	317	Veracruz
2020-05-23	455	597	1,052	139	168	307	Veracruz
2020-05-24	510	593	1,103	154	164	318	Veracruz
2020-05-25	454	623	1,077	166	160	326	Veracruz
2020-05-26	476	633	1,109	173	169	342	Veracruz
2020-05-27	484	670	1,154	168	180	348	Veracruz
2020-05-28	488	659	1,147	161	187	348	Veracruz
2020-05-29	438	659	1,097	165	170	335	Veracruz
2020-05-30	431	666	1,097	142	169	311	Veracruz
2020-05-31	474	697	1,171	151	179	330	Veracruz
2020-06-01	507	699	1,206	171	148	319	Veracruz
2020-06-02	558	657	1,215	167	181	348	Veracruz
2020-06-03	540	636	1,176	159	182	341	Veracruz
2020-06-04	535	668	1,203	170	177	347	Veracruz
2020-06-05	532	622	1,154	159	170	329	Veracruz
2020-06-06	506	595	1,101	159	171	330	Veracruz
2020-06-07	522	595	1,117	162	176	338	Veracruz
2020-06-08	551	617	1,168	180	159	339	Veracruz
2020-06-09	550	584	1,134	178	164	342	Veracruz
2020-06-10	558	623	1,181	176	179	355	Veracruz
2020-06-11	538	568	1,106	153	226	379	Veracruz
2020-06-12	502	558	1,060	175	203	378	Veracruz
2020-06-13	400	504	904	149	174	323	Veracruz
2020-06-14	480	575	1,055	180	190	370	Veracruz
2020-06-15	449	581	1,030	165	220	385	Veracruz
2020-06-16	536	578	1,114	174	221	395	Veracruz
2020-06-17	464	507	971	160	213	373	Veracruz
2020-06-18	517	576	1,093	189	212	401	Veracruz
2020-06-19	537	569	1,106	186	212	398	Veracruz
2020-06-20	548	555	1,103	178	237	415	Veracruz
2020-06-21	518	600	1,118	161	242	403	Veracruz
2020-06-22	574	579	1,153	170	242	412	Veracruz
2020-06-23	623	590	1,213	172	276	448	Veracruz
2020-06-24	626	569	1,195	174	254	428	Veracruz
2020-06-25	616	522	1,138	186	263	449	Veracruz
2020-06-26	623	528	1,151	188	272	460	Veracruz
2020-06-27	620	543	1,163	183	264	447	Veracruz
2020-06-28	609	528	1,137	178	249	427	Veracruz
2020-06-29	583	523	1,106	187	289	476	Veracruz
2020-06-30	628	515	1,143	199	270	469	Veracruz
2020-07-01	632	515	1,147	201	286	487	Veracruz
2020-07-02	651	606	1,257	205	280	485	Veracruz
2020-07-03	654	585	1,239	207	244	451	Veracruz
2020-07-04	672	504	1,176	212	267	479	Veracruz
2020-07-05	699	515	1,214	196	263	459	Veracruz
2020-07-06	740	510	1,250	208	259	467	Veracruz
2020-07-07	711	459	1,170	199	198	397	Veracruz
2020-07-08	728	486	1,214	191	255	446	Veracruz
2020-07-09	763	485	1,248	227	247	474	Veracruz
2020-07-10	762	456	1,218	224	246	470	Veracruz
2020-07-11	706	391	1,097	190	200	390	Veracruz
2020-07-12	794	442	1,236	205	268	473	Veracruz
2020-07-13	787	494	1,281	206	267	473	Veracruz
2020-07-14	826	498	1,324	203	236	439	Veracruz
2020-07-15	802	449	1,251	205	213	418	Veracruz
2020-07-16	834	481	1,315	222	224	446	Veracruz
2020-07-17	784	498	1,282	192	231	423	Veracruz
2020-07-18	839	504	1,343	211	236	447	Veracruz
2020-07-19	835	514	1,349	212	234	446	Veracruz
2020-07-20	846	490	1,336	203	244	447	Veracruz
2020-07-21	852	494	1,346	213	230	443	Veracruz
2020-07-22	883	516	1,399	217	212	429	Veracruz
2020-07-23	904	470	1,374	211	209	420	Veracruz
2020-07-24	909	493	1,402	233	204	437	Veracruz
2020-07-25	934	478	1,412	222	214	436	Veracruz
2020-07-26	910	458	1,368	228	208	436	Veracruz
2020-07-27	930	458	1,388	231	220	451	Veracruz
2020-07-28	924	515	1,439	214	222	436	Veracruz
2020-07-29	885	520	1,405	230	219	449	Veracruz
2020-07-30	822	506	1,328	213	211	424	Veracruz
2020-07-31	806	551	1,357	207	177	384	Veracruz
2020-08-01	762	479	1,241	204	161	365	Veracruz
2020-08-02	889	552	1,441	219	231	450	Veracruz
2020-08-03	881	571	1,452	192	244	436	Veracruz
2020-08-04	875	615	1,490	196	239	435	Veracruz
2020-08-05	815	623	1,438	191	244	435	Veracruz
2020-08-06	781	660	1,441	188	245	433	Veracruz
2020-08-07	706	680	1,386	197	256	453	Veracruz
2020-08-08	701	720	1,421	192	263	455	Veracruz
2020-08-09	690	727	1,417	200	257	457	Veracruz
2020-08-10	698	709	1,407	206	273	479	Veracruz
2020-08-11	687	707	1,394	199	259	458	Veracruz
2020-08-12	685	709	1,394	182	266	448	Veracruz
2020-08-13	661	713	1,374	177	297	474	Veracruz
2020-08-14	659	722	1,381	167	287	454	Veracruz
2020-08-15	658	735	1,393	167	283	450	Veracruz
2020-08-16	624	768	1,392	163	297	460	Veracruz
2020-08-17	601	776	1,377	161	308	469	Veracruz
2020-08-18	598	761	1,359	159	319	478	Veracruz
2020-08-19	587	787	1,374	166	329	495	Veracruz
2020-08-20	562	801	1,363	156	323	479	Veracruz
2020-08-21	565	815	1,380	152	316	468	Veracruz
2020-08-22	526	811	1,337	138	314	452	Veracruz
2020-08-23	500	823	1,323	138	309	447	Veracruz
2020-08-24	537	816	1,353	141	337	478	Veracruz
2020-08-25	542	831	1,373	140	339	479	Veracruz
2020-08-26	528	845	1,373	147	331	478	Veracruz
2020-08-27	535	825	1,360	130	297	427	Veracruz
2020-08-28	553	825	1,378	149	313	462	Veracruz
2020-08-29	542	788	1,330	142	302	444	Veracruz
2020-08-30	528	775	1,303	139	298	437	Veracruz
2020-08-31	553	840	1,393	153	319	472	Veracruz
2020-09-01	533	824	1,357	147	326	473	Veracruz
2020-09-02	534	857	1,391	152	328	480	Veracruz
2020-09-03	551	844	1,395	139	324	463	Veracruz
2020-09-04	481	806	1,287	125	294	419	Veracruz
2020-09-05	529	809	1,338	127	333	460	Veracruz
2020-09-06	519	829	1,348	127	337	464	Veracruz
2020-04-07	9	128	137	4	103	107	Yucatán
2020-04-08	9	128	137	4	103	107	Yucatán
2020-04-09	8	149	157	4	98	102	Yucatán
2020-04-10	8	165	173	4	99	103	Yucatán
2020-04-11	10	194	204	2	108	110	Yucatán
2020-04-12	12	172	184	2	100	102	Yucatán
2020-04-13	13	172	185	3	97	100	Yucatán
2020-04-14	13	173	186	5	91	96	Yucatán
2020-04-15	11	173	184	6	90	96	Yucatán
2020-04-16	13	173	186	7	90	97	Yucatán
2020-04-17	17	196	213	11	121	132	Yucatán
2020-04-18	17	202	219	7	126	133	Yucatán
2020-04-19	25	199	224	6	105	111	Yucatán
2020-04-20	28	200	228	10	114	124	Yucatán
2020-04-21	30	282	312	11	219	230	Yucatán
2020-04-22	31	269	300	10	159	169	Yucatán
2020-04-23	29	336	365	12	168	180	Yucatán
2020-04-24	26	336	362	11	167	178	Yucatán
2020-04-25	28	332	360	14	152	166	Yucatán
2020-04-26	39	332	371	13	152	165	Yucatán
2020-04-27	45	360	405	12	181	193	Yucatán
2020-04-28	46	357	403	11	125	136	Yucatán
2020-04-29	78	333	411	11	101	112	Yucatán
2020-04-30	75	370	445	10	115	125	Yucatán
2020-05-01	72	363	435	12	102	114	Yucatán
2020-05-02	88	352	440	22	125	147	Yucatán
2020-05-03	93	367	460	22	141	163	Yucatán
2020-05-04	90	348	438	22	158	180	Yucatán
2020-05-05	89	350	439	21	129	150	Yucatán
2020-05-06	94	357	451	23	134	157	Yucatán
2020-05-07	92	359	451	27	127	154	Yucatán
2020-05-08	91	364	455	24	141	165	Yucatán
2020-05-09	96	346	442	27	135	162	Yucatán
2020-05-10	95	350	445	29	137	166	Yucatán
2020-05-11	98	351	449	30	149	179	Yucatán
2020-05-12	99	317	416	31	146	177	Yucatán
2020-05-13	101	332	433	38	136	174	Yucatán
2020-05-14	107	318	425	31	148	179	Yucatán
2020-05-15	100	318	418	26	141	167	Yucatán
2020-05-16	108	317	425	33	143	176	Yucatán
2020-05-17	112	313	425	29	136	165	Yucatán
2020-05-18	123	316	439	35	141	176	Yucatán
2020-05-19	117	317	434	35	142	177	Yucatán
2020-05-20	118	314	432	41	130	171	Yucatán
2020-05-21	120	315	435	36	119	155	Yucatán
2020-05-22	113	317	430	41	131	172	Yucatán
2020-05-23	111	310	421	43	118	161	Yucatán
2020-05-24	116	313	429	40	124	164	Yucatán
2020-05-25	118	317	435	41	134	175	Yucatán
2020-05-26	103	306	409	29	93	122	Yucatán
2020-05-27	120	311	431	42	123	165	Yucatán
2020-05-28	131	311	442	39	130	169	Yucatán
2020-05-29	116	322	438	42	123	165	Yucatán
2020-05-30	113	303	416	31	73	104	Yucatán
2020-05-31	111	307	418	47	111	158	Yucatán
2020-06-01	93	331	424	49	125	174	Yucatán
2020-06-02	103	314	417	42	126	168	Yucatán
2020-06-03	104	313	417	41	126	167	Yucatán
2020-06-04	119	321	440	42	126	168	Yucatán
2020-06-05	95	310	405	44	115	159	Yucatán
2020-06-06	95	307	402	45	116	161	Yucatán
2020-06-07	128	310	438	42	129	171	Yucatán
2020-06-08	132	319	451	46	138	184	Yucatán
2020-06-09	128	272	400	48	114	162	Yucatán
2020-06-10	141	273	414	52	120	172	Yucatán
2020-06-11	148	273	421	54	130	184	Yucatán
2020-06-12	143	265	408	50	105	155	Yucatán
2020-06-13	127	273	400	54	104	158	Yucatán
2020-06-14	111	275	386	42	68	110	Yucatán
2020-06-15	144	279	423	47	106	153	Yucatán
2020-06-16	142	271	413	50	101	151	Yucatán
2020-06-17	131	280	411	51	107	158	Yucatán
2020-06-18	107	268	375	40	69	109	Yucatán
2020-06-19	128	350	478	58	176	234	Yucatán
2020-06-20	136	329	465	51	149	200	Yucatán
2020-06-21	156	357	513	53	159	212	Yucatán
2020-06-22	169	353	522	58	160	218	Yucatán
2020-06-23	196	373	569	62	179	241	Yucatán
2020-06-24	218	376	594	59	180	239	Yucatán
2020-06-25	226	368	594	58	184	242	Yucatán
2020-06-26	210	368	578	66	180	246	Yucatán
2020-06-27	220	364	584	71	180	251	Yucatán
2020-06-28	238	358	596	72	179	251	Yucatán
2020-06-29	248	348	596	76	173	249	Yucatán
2020-06-30	256	332	588	74	172	246	Yucatán
2020-07-01	281	296	577	75	165	240	Yucatán
2020-07-02	276	286	562	75	164	239	Yucatán
2020-07-03	283	837	1,120	79	200	279	Yucatán
2020-07-04	249	756	1,005	65	103	168	Yucatán
2020-07-05	298	772	1,070	88	163	251	Yucatán
2020-07-06	300	764	1,064	88	162	250	Yucatán
2020-07-07	311	752	1,063	92	144	236	Yucatán
2020-07-08	330	752	1,082	95	162	257	Yucatán
2020-07-09	297	708	1,005	75	71	146	Yucatán
2020-07-10	327	684	1,011	105	153	258	Yucatán
2020-07-11	334	712	1,046	107	161	268	Yucatán
2020-07-12	346	684	1,030	108	149	257	Yucatán
2020-07-13	347	675	1,022	115	154	269	Yucatán
2020-07-14	358	687	1,045	111	156	267	Yucatán
2020-07-15	394	661	1,055	117	159	276	Yucatán
2020-07-16	393	654	1,047	116	160	276	Yucatán
2020-07-17	427	634	1,061	110	158	268	Yucatán
2020-07-18	426	637	1,063	117	161	278	Yucatán
2020-07-19	421	621	1,042	116	154	270	Yucatán
2020-07-20	406	611	1,017	124	156	280	Yucatán
2020-07-21	414	625	1,039	111	158	269	Yucatán
2020-07-22	424	626	1,050	117	150	267	Yucatán
2020-07-23	392	613	1,005	126	150	276	Yucatán
2020-07-24	420	622	1,042	129	156	285	Yucatán
2020-07-25	424	615	1,039	125	136	261	Yucatán
2020-07-26	399	618	1,017	116	151	267	Yucatán
2020-07-27	365	569	934	98	82	180	Yucatán
2020-07-28	436	634	1,070	128	144	272	Yucatán
2020-07-29	444	655	1,099	112	156	268	Yucatán
2020-07-30	428	651	1,079	119	158	277	Yucatán
2020-07-31	391	599	990	121	144	265	Yucatán
2020-08-01	389	609	998	124	138	262	Yucatán
2020-08-02	415	667	1,082	125	149	274	Yucatán
2020-08-03	423	630	1,053	122	161	283	Yucatán
2020-08-04	430	684	1,114	134	160	294	Yucatán
2020-08-05	437	618	1,055	134	156	290	Yucatán
2020-08-06	437	622	1,059	132	149	281	Yucatán
2020-08-07	434	599	1,033	124	166	290	Yucatán
2020-08-08	453	608	1,061	124	166	290	Yucatán
2020-08-09	446	634	1,080	123	166	289	Yucatán
2020-08-10	447	639	1,086	127	162	289	Yucatán
2020-08-11	459	609	1,068	128	166	294	Yucatán
2020-08-12	429	624	1,053	121	132	253	Yucatán
2020-08-13	420	612	1,032	111	122	233	Yucatán
2020-08-14	454	613	1,067	119	115	234	Yucatán
2020-08-15	447	622	1,069	117	117	234	Yucatán
2020-08-16	472	609	1,081	120	115	235	Yucatán
2020-08-17	491	597	1,088	111	123	234	Yucatán
2020-08-18	464	617	1,081	109	121	230	Yucatán
2020-08-19	422	648	1,070	104	127	231	Yucatán
2020-08-20	410	644	1,054	100	131	231	Yucatán
2020-08-21	400	644	1,044	88	135	223	Yucatán
2020-08-22	368	663	1,031	60	115	175	Yucatán
2020-08-23	401	665	1,066	90	150	240	Yucatán
2020-08-24	385	686	1,071	85	150	235	Yucatán
2020-08-25	365	690	1,055	76	153	229	Yucatán
2020-08-26	376	675	1,051	63	159	222	Yucatán
2020-08-27	345	696	1,041	73	172	245	Yucatán
2020-08-28	339	705	1,044	63	182	245	Yucatán
2020-08-29	350	715	1,065	66	188	254	Yucatán
2020-08-30	336	726	1,062	78	175	253	Yucatán
2020-08-31	329	740	1,069	73	176	249	Yucatán
2020-09-01	310	751	1,061	73	178	251	Yucatán
2020-09-02	316	774	1,090	72	159	231	Yucatán
2020-09-03	301	783	1,084	72	155	227	Yucatán
2020-09-04	267	802	1,069	65	165	230	Yucatán
2020-09-05	270	805	1,075	62	173	235	Yucatán
2020-09-06	283	769	1,052	62	174	236	Yucatán
2020-04-07	1	71	72	1	81	82	Zacatecas
2020-04-08	1	71	72	1	81	82	Zacatecas
2020-04-09	0	71	71	1	63	64	Zacatecas
2020-04-10	0	71	71	1	61	62	Zacatecas
2020-04-11	2	70	72	1	58	59	Zacatecas
2020-04-12	3	70	73	1	56	57	Zacatecas
2020-04-13	3	71	74	1	55	56	Zacatecas
2020-04-14	2	71	73	3	55	58	Zacatecas
2020-04-15	3	70	73	2	60	62	Zacatecas
2020-04-16	5	69	74	1	61	62	Zacatecas
2020-04-17	6	70	76	2	60	62	Zacatecas
2020-04-18	8	70	78	2	60	62	Zacatecas
2020-04-19	5	70	75	2	58	60	Zacatecas
2020-04-20	4	71	75	1	62	63	Zacatecas
2020-04-21	6	116	122	0	107	107	Zacatecas
2020-04-22	6	116	122	0	51	51	Zacatecas
2020-04-23	6	116	122	0	51	51	Zacatecas
2020-04-24	6	116	122	0	51	51	Zacatecas
2020-04-25	8	117	125	0	49	49	Zacatecas
2020-04-26	9	118	127	0	49	49	Zacatecas
2020-04-27	8	219	227	0	49	49	Zacatecas
2020-04-28	13	274	287	5	70	75	Zacatecas
2020-04-29	16	277	293	5	73	78	Zacatecas
2020-04-30	20	274	294	5	75	80	Zacatecas
2020-05-01	13	274	287	4	75	79	Zacatecas
2020-05-02	15	272	287	3	76	79	Zacatecas
2020-05-03	16	272	288	1	66	67	Zacatecas
2020-05-04	22	271	293	0	71	71	Zacatecas
2020-05-05	23	271	294	0	68	68	Zacatecas
2020-05-06	17	269	286	1	65	66	Zacatecas
2020-05-07	23	266	289	1	69	70	Zacatecas
2020-05-08	18	268	286	4	65	69	Zacatecas
2020-05-09	16	268	284	3	67	70	Zacatecas
2020-05-10	13	268	281	3	71	74	Zacatecas
2020-05-11	11	264	275	3	69	72	Zacatecas
2020-05-12	11	263	274	3	69	72	Zacatecas
2020-05-13	15	262	277	4	68	72	Zacatecas
2020-05-14	18	268	286	3	68	71	Zacatecas
2020-05-15	19	264	283	3	66	69	Zacatecas
2020-05-16	15	269	284	4	68	72	Zacatecas
2020-05-17	18	268	286	4	68	72	Zacatecas
2020-05-18	15	264	279	5	70	75	Zacatecas
2020-05-19	16	259	275	5	63	68	Zacatecas
2020-05-20	10	264	274	3	61	64	Zacatecas
2020-05-21	10	265	275	3	59	62	Zacatecas
2020-05-22	16	267	283	5	60	65	Zacatecas
2020-05-23	16	266	282	5	61	66	Zacatecas
2020-05-24	20	267	287	5	61	66	Zacatecas
2020-05-25	24	261	285	5	64	69	Zacatecas
2020-05-26	21	253	274	7	64	71	Zacatecas
2020-05-27	37	258	295	7	63	70	Zacatecas
2020-05-28	39	220	259	5	68	73	Zacatecas
2020-05-29	34	224	258	6	67	73	Zacatecas
2020-05-30	20	217	237	5	73	78	Zacatecas
2020-05-31	29	227	256	5	70	75	Zacatecas
2020-06-01	26	226	252	9	66	75	Zacatecas
2020-06-02	17	216	233	9	64	73	Zacatecas
2020-06-03	12	222	234	12	64	76	Zacatecas
2020-06-04	20	234	254	14	59	73	Zacatecas
2020-06-05	23	231	254	15	59	74	Zacatecas
2020-06-06	14	221	235	14	59	73	Zacatecas
2020-06-07	26	229	255	16	59	75	Zacatecas
2020-06-08	22	213	235	17	59	76	Zacatecas
2020-06-09	32	248	280	10	61	71	Zacatecas
2020-06-10	27	222	249	15	64	79	Zacatecas
2020-06-11	33	240	273	13	61	74	Zacatecas
2020-06-12	29	243	272	13	66	79	Zacatecas
2020-06-13	32	220	252	12	67	79	Zacatecas
2020-06-14	37	238	275	12	61	73	Zacatecas
2020-06-15	38	217	255	13	62	75	Zacatecas
2020-06-16	41	234	275	12	68	80	Zacatecas
2020-06-17	43	233	276	13	61	74	Zacatecas
2020-06-18	36	218	254	14	63	77	Zacatecas
2020-06-19	37	238	275	16	61	77	Zacatecas
2020-06-20	38	239	277	14	61	75	Zacatecas
2020-06-21	36	273	309	14	82	96	Zacatecas
2020-06-22	37	251	288	15	80	95	Zacatecas
2020-06-23	44	263	307	19	77	96	Zacatecas
2020-06-24	49	259	308	14	79	93	Zacatecas
2020-06-25	44	242	286	19	77	96	Zacatecas
2020-06-26	54	241	295	20	77	97	Zacatecas
2020-06-27	59	237	296	19	75	94	Zacatecas
2020-06-28	60	235	295	17	77	94	Zacatecas
2020-06-29	56	230	286	19	78	97	Zacatecas
2020-06-30	66	245	311	20	76	96	Zacatecas
2020-07-01	66	245	311	17	76	93	Zacatecas
2020-07-02	64	248	312	17	73	90	Zacatecas
2020-07-03	76	256	332	15	74	89	Zacatecas
2020-07-04	69	240	309	14	95	109	Zacatecas
2020-07-05	64	245	309	17	99	116	Zacatecas
2020-07-06	56	250	306	28	89	117	Zacatecas
2020-07-07	57	230	287	27	90	117	Zacatecas
2020-07-08	56	207	263	25	90	115	Zacatecas
2020-07-09	61	230	291	29	90	119	Zacatecas
2020-07-10	49	260	309	31	91	122	Zacatecas
2020-07-11	55	266	321	33	91	124	Zacatecas
2020-07-12	61	263	324	33	89	122	Zacatecas
2020-07-13	70	278	348	28	94	122	Zacatecas
2020-07-14	69	270	339	36	82	118	Zacatecas
2020-07-15	84	246	330	33	82	115	Zacatecas
2020-07-16	86	250	336	35	86	121	Zacatecas
2020-07-17	66	246	312	37	81	118	Zacatecas
2020-07-18	76	220	296	35	86	121	Zacatecas
2020-07-19	89	251	340	38	84	122	Zacatecas
2020-07-20	97	235	332	42	78	120	Zacatecas
2020-07-21	91	226	317	43	76	119	Zacatecas
2020-07-22	91	150	241	44	77	121	Zacatecas
2020-07-23	96	146	242	43	92	135	Zacatecas
2020-07-24	100	146	246	48	87	135	Zacatecas
2020-07-25	100	150	250	48	85	133	Zacatecas
2020-07-26	96	158	254	47	86	133	Zacatecas
2020-07-27	105	145	250	45	87	132	Zacatecas
2020-07-28	112	130	242	53	77	130	Zacatecas
2020-07-29	115	128	243	53	75	128	Zacatecas
2020-07-30	106	209	315	66	66	132	Zacatecas
2020-07-31	116	201	317	68	64	132	Zacatecas
2020-08-01	122	194	316	74	72	146	Zacatecas
2020-08-02	119	171	290	68	75	143	Zacatecas
2020-08-03	131	175	306	72	85	157	Zacatecas
2020-08-04	128	186	314	75	73	148	Zacatecas
2020-08-05	133	177	310	75	74	149	Zacatecas
2020-08-06	124	184	308	78	73	151	Zacatecas
2020-08-07	117	192	309	70	78	148	Zacatecas
2020-08-08	124	195	319	62	83	145	Zacatecas
2020-08-09	119	197	316	54	91	145	Zacatecas
2020-08-10	129	187	316	55	101	156	Zacatecas
2020-08-11	129	185	314	60	98	158	Zacatecas
2020-08-12	127	183	310	58	100	158	Zacatecas
2020-08-13	125	223	348	61	100	161	Zacatecas
2020-08-14	115	236	351	58	101	159	Zacatecas
2020-08-15	114	240	354	60	102	162	Zacatecas
2020-08-16	124	233	357	57	99	156	Zacatecas
2020-08-17	141	222	363	60	101	161	Zacatecas
2020-08-18	144	211	355	59	109	168	Zacatecas
2020-08-19	138	214	352	59	106	165	Zacatecas
2020-08-20	144	212	356	53	110	163	Zacatecas
2020-08-21	139	217	356	57	106	163	Zacatecas
2020-08-22	128	232	360	57	105	162	Zacatecas
2020-08-23	122	235	357	54	107	161	Zacatecas
2020-08-24	130	230	360	51	109	160	Zacatecas
2020-08-25	152	216	368	51	106	157	Zacatecas
2020-08-26	144	224	368	53	103	156	Zacatecas
2020-08-27	136	225	361	52	105	157	Zacatecas
2020-08-28	137	214	351	49	108	157	Zacatecas
2020-08-29	138	214	352	52	103	155	Zacatecas
2020-08-30	133	221	354	51	104	155	Zacatecas
2020-08-31	149	217	366	52	100	152	Zacatecas
2020-09-01	121	202	323	50	103	153	Zacatecas
2020-09-02	124	231	355	50	107	157	Zacatecas
2020-09-03	114	240	354	50	106	156	Zacatecas
2020-09-04	107	244	351	54	103	157	Zacatecas
2020-09-05	105	249	354	56	100	156	Zacatecas
2020-09-06	118	240	358	47	104	151	Zacatecas

